分体	분체	0
ひと呼吸	한 호흡	0
常世	영원불변	0
羽音	날개소리	0
修羅道	수라도	0
トルマリン	투르말린	0
ノーム	노움	0
マジック	매직
イーター	이터
セクシーズ	섹시즈
鼻髭	콧수염
キャラベル船	캐러벨
マスト	돛대
インプ	임프
めんつゆ	소바 국물
ぶんし	분자
ミョウバン	명반
ぐーたら	무기력한 느낌
てきと	적당하게
ジャパナイズ	일본화
スボコ	수복
ソウネ	그렇네