//필터링에서 사용된 더미 명사
乘名	名:	1	//명사 접두
梦名	#M二	1	//명사 접미
乘動	動:	1	//동사생성 접두
乘形	形:	1	//형용사생성 접두
乘受	受:	1	//수동형 접두
乘加	加:	1	//더미용 명사
戰戰	#M二	1	//~する형에서 쓰이는 접미어로, 다른 등록된 명사가 있는 경우, #M가 됨.
梦彼	#N二	1	VHn	//호칭명사 및 이름 접미
くん梦彼	군#N二	1	VHn	//君
クン梦彼	군#N二	1	VHn	//君
ちゃん梦彼	짱#N二	1	VHn	//ちゃん
前梦名	앞	1	VPl	//장소

//#.'필터링으로 조작된 어휘들
//▀▀▀▀▀▀▀▀▀▀▀▀▀▀▀▀▀▀▀▀▀▀▀▀▀▀▀▀▀▀▀▀▀▀▀▀▀▀▀▀▀▀▀▀▀▀▀▀▀▀▀▀▀▀▀▀▀▀▀▀▀▀▀▀▀▀▀▀▀▀▀▀▀▀▀▀▀
//い 형용사 자연스런 번역
うまゎ形	맛있어	0
うまぁゎ形	맛있어	0
うれしゎ形	기뻐	0
うらやましゎ形	부러워	0
うれっしゎ形	기뻐	0
おいしゎ形	맛있어	0	//おいし～♪
おいっしゎ形	맛있어	0	//おいっし～♪
おいしゎ形	맛있어	0
おかしゎ形	이상해	0
おっかしゎ形	이상해	0
おっそゎ形	늦다	0
くやしゎ形	분해	0
くやっしゎ形	분해	0
こわゎ形	무서워	0
すごゎ形	굉장해	0
すごゎ形	굉장해	0
すきゎ形	좋아	0
ひどゎ形	너무해	0
やばゎ形	위험해	0
うっせゎ形	시끄러	0
うっぜゎ形	짜증나	0
美味しゎ形	맛있어	0
//
あぶねゎ形	위험해	0
アブねゎ形	위험해	0
いらねゎ形	필요없어	0
危ねゎ形	위험해	0
こええゎ形	무서워	0
こえぇゎ形	무서워	0
//
甘ゎ形	달다	0
高ゎ形	높다	0
怖ゎ形	무서워	0
熱ゎ形	뜨거워	0
早ゎ形	빨라	0	//「早っ！？」
遅ゎ形	늦어	0
多ゎ形	많아	0
違ゎ形	달라	0
寒ゎ形	추워	0	//寒っ
速ゎ形	빨라	0	//速っ…。
やべゎ形	위험해	0

//호칭'명사
義理の父梦彼	의붓아버지#N	1	VHn	//인간
義理の母梦彼	의붓어머니#N	1	VHn	//인간
義理の娘梦彼	의붓딸#N	1	VHn	//인간
義理の妹梦彼	의붓여동생#N	1	VHn	//인간
義理の弟梦彼	의붓남동생#N	1	VHn	//인간
モテ男梦彼	인기남#N	1	VHn	//인간
甘ちゃん梦彼	응석받이#N	1	VHn	//인간
ナデシコ梦彼	나데시코#N	1	VHn	//인간
イタズラッ子梦彼	장난꾸러기#N	1	VHn	//인간 : いたずらっ子
ウスノロ梦彼	얼간이#N	1	VHn	//인간 : うすのろ
コイツ梦彼	이 녀석#N	1	VHn	//인간 : 
シニガミ梦彼	사신#N	1	VGn	//신(성인)
ショジョ梦名	처녀#N	1	VHn	//인간 : でかぶつ
デカブツ梦彼	멍청이#N	1	VHn	//인간 : でかぶつ
ハニカミヤ梦彼	부끄럼쟁이#N	1	VHn	//인간 : はにかみや
ヘンシツシャ梦彼	변절자#N	1	VHn	//인간 : へんしつしゃ
我ガ君梦彼	나랏님#N	1	VHn	//인간 : 我が君
ワガ君梦彼	나랏님#N	1	VHn	//인간 : わが君
我ガ主梦彼	주인님#N	1	VHn	//인간 : 我が主
ワガ主梦彼	주인님#N	1	VHn	//인간 : わが主
我ガ輩梦彼	소인#N	1	VHn	//인간 :
ワガ輩梦彼	소인#N	1	VHn	//인간 :
ナラズ者梦彼	불량배#N	1	VHn	//인간 :
徒士梦彼	하급 사무라이#N	1	VHn	//인간 :
アイツ梦彼	저 녀석#N	1	VHn	//인간 : 
ソイツ梦彼	그 녀석#N	1	VHn	//인간 : 
アヤツ梦彼	저 녀석#N	1	VHn	//인간 : 
ソヤツ梦彼	그 녀석#N	1	VHn	//인간 : 
アクマ梦彼	악마#N	1	VHn	//인간 : 
アニキ梦彼	형님#N	1	VHn	//인간 : 
アニキー梦彼	형님#N	1	VHn	//인간 : 
オクテ梦彼	늦깎이	1	VHn	//인간 : 
ガキ梦彼	꼬마#N	1	VHn	//인간 : ガキ、悪ガキ
ケモノ梦彼	짐승#N	1	VAm	//동물
シャケ梦彼	연어#N	1	VAm	//동물
セフレ梦彼	섹스프렌드#N	1	VHn	//인간 : セフレ
ゾウ梦彼	코끼리#N	1	VAm	//동물
チカン梦彼	치한#N	1	VHn	//인간 : 
ブス梦彼	추녀#N	1	VHn	//인간 : ブス
ボウヤ梦彼	꼬마#N	1	VHn	//인간 : ブス
マメ男梦彼	성실남#N	1	VHn	//인간 : 
パギャル梦彼	파갸루#N	1	VHn	//인간 : 
ギルマス梦彼	길드 마스터#N	1	VHn	//인간 : 
オジン梦彼	아저씨#N	1	VHn	//인간 : 
アサリ梦名	바지락	1	QAC	// :어류
メンクイ梦彼	얼굴 밝히는 사람#N	1	VHn	//인간 
オジイサン梦彼	할아버지#N	1	VHn	//인간 
古ナジミ梦彼	오랜 친구#N	1	VHn	//인간 
害児梦彼	장애아#N	1	VHn	//인간 : 害児
鵺梦彼	누에[ぬえ]#N	1	VAm	//동물
蠅梦彼	파리#N	1	QAE	//곤충류
佛梦彼	부처#N	1	VGn	//신(성인)
牡梦彼	수컷#N	1	VAm	//동물
豹梦名	표범#N	1	VAm	//동물
牝梦彼	암컷#N	1	VAm	//동물
蠍梦名	전갈	1	VAm	//동물
奥梦彼	사모#N	1	VHn	//인간 : 奥さま
仏梦彼	부처#N	1	VGn	//신(성인)
現生徒梦彼	현학생#N	1	VHn	//인간 : 
厨二梦彼	중2#N	1	VHn	//인간 : 
茶目梦彼	장난꾸러기#N	1	VHn	//인간 : 
妖し梦彼	요괴#N	1	VHn	//인간 : 
獣達梦彼	짐승들#N	1	VHn	//인간 : 
婿梦彼	신랑#N	1	VHn	//인간 :
輩梦彼	무리#N	1	VHn	//인간 :
村衆梦彼	마을 사람들#N	1	VHn	//인간 :
御師	신관[御師]#N	1	VHn	//인간 : 
オナゴ梦彼	계집#N	1	VHn	//인간 : 
ノケ者梦名	제외자#N	1	VHn	//인간 : 
テレ屋梦彼	수줍음쟁이#N	1	VHn	//인간 : 
イイダシッペ梦彼	먼저 말꺼낸 사람#N	1	VHn	//인간 : いいだしっぺ
ヤツラ梦名	녀석들#N	1	VHn	//인간
とある人梦彼	어떤 사람#N	1	VHn	//인간
仕え梦彼	시중[仕え]#N	1	VHn	//城仕え
配偶梦彼	배우자#N	1	VHn	//彼らの出してきた中から配偶を選び、
狂い梦彼	광[狂い]#N	1	VHn	//
蝮梦名	살무사	1	VAm	//동물
名主梦彼	명주[名主]#N	1	VHn

//기타'명사
鉈梦名	손도끼	1	VTw	//무기 :
アニソン梦名	애니송	1	USo	// :노래
イタズラ心梦名	장난끼	1	UFl	//감정
ウサ耳梦名	토끼귀	1	VBp	//신체부위 : 
憂イ顔	슬픈 얼굴	1	VBp	//신체부위 : 
海岸通リ	부둣가	1	VPl	//장소 : 海岸通り (かいがんとおり)
タイ焼キ梦名	붕어빵	1	VFd	//음식
食いもの梦名	먹을 것	1	VFd	//음식
ハジッコ梦名	가장자리	1	VPl	//장소 :
岬梦名	곶	1	VPl	//장소 :
庵梦名	초막	1	VPl	//장소 :
コメカミ梦名	관자놀이	1	VBp	//신체부위 : 
//
ガラケー梦名	피쳐폰	1	VEl	//전기기구
アクセ梦名	악세사리	1	VAc	//장신구
クリッ梦名	클리	1	VBp	//신체부위 : 
クリ梦名	클리	1	VBp	//신체부위 : 
タンス梦名	옷장	1	VFn	//가구
ガバマン梦名	헐렁보지	1	VBp	//신체부위 : 
デパ梦名	백화점	1	VPl	//장소 :
カツヤクキン梦名	괄약근	1	VBp	//신체부위 : 
フリマ梦名	프리마켓	1	VPl	//장소 :
アッタマ梦名	머리	1	VBp	//신체부위 : 
ガッコー梦名	학교	1	VPl	//장소 :
メンチ梦名	다진 고기	1	VFd	//음식
メシ梦名	밥	1	VFd	//음식
中ボス梦名	중간보스#N	1	VHn	//인간 : 
マンガ喫茶梦名	만화 카페	1	VPl	//장소 :
ラム肉梦名	어린 양고기	1	VFd	//음식
セカイ梦名	세계	1	VPl	//장소 :
食いカス梦名	먹은 찌꺼기	1	VFd	//음식(음료)
学ラン梦名	남학생복	1	VCp	//의복
白スク梦名	흰색 학교 수영복	1	VCp	//의복
マン汁梦名	보짓물	1	VLu	//분비물
タンキニ梦名	탱키니	1	VCp	//의복 : 탱크탑 비키니
スク水梦名	학교 수영복	1	VCp	//의복
海パン梦名	수영 팬츠	1	VCp	//의복
兜梦名	투구	1	VCp	//의복
蔓梦名	덩굴	1	VPt	//식물 :
蔦梦名	담쟁이덩굴	1	VPt	//식물 :
額梦名	이마	1	VBp	//신체부위 : 
臍梦名	배꼽	1	VBp	//신체부위 : 
キツマン梦名	쪼임 보지	1	VBp	//신체부위 : 
閨梦名	침실	1	VPl	//장소 :
坂の上梦名	언덕 위	1	VPl	//장소
坂の下梦名	언덕 아래	1	VPl	//장소
獣道梦名	짐승 다니는 길	1	VPl	//장소
公の場梦名	공적인 자리	1	VPl	//장소
大地梦名	대지	1	VPl	//장소 : 空は暗く曇り、大地は枯れ
許梦名	계신 곳	1	VPl	//장소 : 小走りに公爵の許へやって来ると
尿梦名	오줌	1	VLu	//분비물 : 鋼鉄の貞操帯は、臭気を放つ彼女の尿にまみれながら役目を終えたのだ。
肋梦名	늑골	1	VBp	//신체부위 : 
側梦名	곁	1	VPl	//장소
お冠梦名	저기압	1	UFl	// :감정
番所梦名	초소	1	VPl	//장소
割目梦名	균열	1	VPl	//장소
領境梦名	영지 경계	1	VPl	//장소
鱚梦名	어류	1	QAC	//어류
マン肉梦名	보짓살	1	VBp	//신체부위 : 
本達梦名	책들	1	VBk	//책
膳梦名	밥상	1	VFn	//가구
日の本梦名	일본	1	QNN	// :국가명
日ノ本梦名	일본	1	QNN	// :국가명
鬱梦名	울적함	1	UYi	// :인간&동물 내적 형용
炉梦名	노[爐]	1	VPl	//장소
牢梦名	감옥	1	VPl	//장소
小城梦名	작은 성	1	VPl	//장소
こっち梦名	이쪽	1	VPl	//장소
そっち梦名	그쪽	1	VPl	//장소
鍬梦名	괭이	1	VPe	//도구
箒梦名	빗자루	1	VPe	//도구
槌梦名	망치	1	VPe	//도구
台拭き梦名	행주	1	VPe	//도구
砦梦名	요새	1	VPl	//장소
原付梦名	원동기	1	VTp	// :교통수단
紐パン梦名	끈팬티	1	VCp	//의복
蜜梦名	꿀	1	VLq	// :액체
邸梦名	저택	1	VPl	//장소
紐パンッ梦名	끈팬티	1	VCp	//의복
晩メシ梦名	저녁밥	1	VFd	//음식(음료)
お腹の中梦名	뱃속	1	UYi	//인간&동물 내적 형용
腹の中梦名	뱃속	1	UYi	//인간&동물 내적 형용
お腹のうち梦名	뱃속	1	UYi	//인간&동물 내적 형용: 誰にも腹のうちを見せない。
腹のうち梦名	뱃속	1	UYi	//인간&동물 내적 형용: 誰にも腹のうちを見せない。
お腹の内梦名	뱃속	1	UYi	//인간&동물 내적 형용
腹の内梦名	뱃속	1	UYi	//인간&동물 내적 형용
山の中梦名	산속	1	VPl	//장소
森の中梦名	숲속	1	VPl	//장소
部屋の中梦名	방 안	1	VPl	//장소
時の中梦名	시간 속	1	VPl	//장소
夜の中梦名	밤 중	1	UMe	// :시간
高座梦名	고좌[高座]	1	VPl	//장소
中梦名	안	1	VPl	//장소 中で騒がれたら
ノリ梦名	분위기	1	UFl	//감정 : その場のノリではなかった
手梦名	수	1	UMn	//수단
御託梦名	쓸데없는 소리	1	UTs	//발화(언어수단)
ご託梦名	쓸데없는 소리	1	UTs	//발화(언어수단)
元カレ梦名	옛 남자친구#N	1	VHn	//인간
指ひねり梦名	손가락 꺾기	1	UTt	// :기술
腕ひねり梦名	팔 비틀기	1	UTt	// :기술
飴ちゃん梦彼	엿	1	VFd	//음식(음료)♞
植木梦名	식목	1	VPt	// :식물 植木を眺めている。
架ケ橋梦彼	가교	1	VPl	//장소 架け橋
外堀梦名	바깥 해자	1	VPl	//장소 こうして外堀から埋めていく
宿屋梦名	여인숙	1	VPl	//장소 他の仲間は宿屋へと行くことになる。
ナメシ皮梦名	무두질한 가죽	1	VLt	// :모사(모피) なめし皮
ナメシ革梦名	무두질한 가죽	1	VLt	// :모사(모피) なめし革
豚バラ梦名	돼지 삼겹	1	VFd	//음식(음료)
路電梦名	노면전차	1	VTp	// :교통수단
城梦名	성	1	VPl	//장소
城内梦名	성 안	1	VPl	//장소
ソリ梦名	썰매	1	VTp	// :교통수단
ハメ技梦名	얍삽한 기술	1	UTt	// :기술
鈴の音梦名	방울 소리	1	UHr	//:음향&소리 상태
ニーソ梦名	니삭스	1	VCp	//의복
お堂梦名	사당[お堂]	1	VPl	//장소
置きどころ梦名	둘 곳	1	VPl	//장소
入れどころ梦名	넣을 곳	1	VPl	//장소
帰宅の途梦名	귀가길	1	VPl	//장소
刃下梦名	칼날 아래	1	VPl	//장소
乘内梦名	안	1	VPl	//장소
なに部梦名	무슨 부	1	VPl	//장소
緊急の時梦名	긴급한 때	1	UMe	// :시간
なになに部梦名	무슨 무슨 부	1	VPl	//장소
水場梦名	물 마시는 장소	1	VPl	//장소
寝ぼけた事梦名	잠꼬대 같은 소리	1	UTs	//발화(언어수단)
垂目梦名	쳐진 눈	1	VBp	// :신체부위
淵梦名	늪	1	VPl	//장소
バレー部梦名	배구부	1	VPl	//장소
アノ世梦名	저 세상	1	VPl	//장소
舌の先梦名	혀 끝	1	VBp	// :신체부위

//이하 태그 표시 없는 '명사
ソッコー梦名	즉시	0	//명사는 아니지만...
ショッパナ梦名	애시당초	0	//しょっぱな
ヘマ梦名な	바보 같은	0	//ヘマな
絞りたて梦名	갓 짜낸	0	//絞りたてミルク
生みたて梦名	갓 낳은	0	//
産みたて梦名	갓 낳은	0	//
うみたて梦名	갓 낳은	0	//
私流梦名	나류[私流]	1
俺流梦名	나류[俺流]	1
メートル走梦名	미터 달리기	1	//１００メートル走
会敵梦彼	회적[會敵]	1
刃向かい梦名	저항[刃向かい]	1
歯向かい梦名	저항[齒向かい]	1
逆ハー梦名	역하렘	1
ファック梦名	fuck	1
ガチャ梦名	가챠	1
断り戰梦名	거절(양해)	1	//本人に断りもなく話を進めようとして！
アプリ梦名	앱	1
川の字梦名	川 글자	1
のの字梦名	の 글자	1
への字梦名	へ 글자	1
ハの字梦名	ハ 글자	1
ホの字梦名	ホ 글자	1
大の字梦名	大 글자	1
生肌梦名	생피부	1
片翼梦名	한쪽 날개	1
柵梦名	책[柵]	1
閂梦名	빗장	1
襖梦名	장지[℡오]	1
素梦名	소[素]	1	//彼女の素である。
頬梦名	뺨	1
一門梦名	일문[一門]	1
寝覚め梦名	잠에서 깨어남[寢覺め]	1
身受け梦名	신변 인수[身受け]	1
身請け梦名	신변 인수[身請け]	1
日の本一梦名	일본 제일	1
日ノ本一梦名	일본 제일	1
一柱梦名	한 기둥	1
外観梦名	겉모습	1
珠梦名	구슬	1
光梦名	빛	1
主梦名	주	1
お主梦名	너#N	1
翅梦名	날개	1
天然ボケ梦名	천연 어리버리	1
ボケ梦名	보케	1
連れション梦名	같이 오줌누기	1
立ちション梦名	서서 오줌누기	1
ツラ梦名	면상	1
アニ研梦名	애니메연	1
寸法梦名	계획(형편)	1
マヤカシ梦名	속임수	1
タンレン梦名	단련	1
ボロ泣き梦名	엉엉 울음	1
ゴリ押し梦名	무리한 관철	1
大コケ梦名	크게 넘어짐[大コケ]	1
ウワキ梦名	바람기	1
ニンシン梦名	임신	1
ホコリ梦名	먼지	1	//頭も肩もホコリかぶって
ヘリクツ梦名	억지소리	1
スゲ替エ梦名	교체	1	//すげ替え
ノロ気梦名	배우자 자랑	1
オフゲー梦名	오프라인 게임	1
バカゲー梦名	바보게임	1
格ゲー梦名	격투겜	1
鬱ゲー梦名	우울겜	1
神ゲー梦名	신게임	1
糞ゲー梦名	똥게임	1
運ゲー梦名	운게임	1
萌えゲー梦名	모에겜	1
積みゲー梦名	쌓인 겜	1
電波ゲー梦名	전파겜	1
泣きゲー梦名	감동겜	1
睡眠ゲー梦名	수면겜	1
拔きゲー梦名	누키겜	1
子育てゲー梦名	육성겜	1
ケムクジャラ梦名	털투성이	1
ガセネタ梦名	거짓 정보	1
ナナイロ梦名	일곱 빛깔	1	//なないろ
ナナツイロ梦名	일곱 빛깔	1	//ななついろ
モチのロン梦名	물의 론	1
新手梦名	신참[新手]	1
シビン梦名	요강	1
ジゴウジトク梦名	자업자득	1
ジゴクミミ梦名	지옥귀[地獄耳]	1
ハヤトチリ梦名	지레짐작	1
タンマ梦名	타임[タンマ]	1
身ジロギ梦名	미동	1
良イ悪イ梦名	좋고 나쁨	1
及ビ腰梦名	엉거주춤한 자세	1	//及び腰にもならないの！
イイガカリ梦名	트집	1
生ケ贄梦名	제물	1	//生け贄
喰イップリ梦名	먹는 모습	1	//喰いっぷり
イチコロ梦名	일살[一殺]	1
イボ梦名	돌기	1
ウインク梦名	윙크	1
エコー梦名	에코	1
難事梦名	어려운 일	1
アザ梦名	멍	1
サビ梦名	후렴구	1
エッセー梦名	에세이	1
オンブ梦名	어부바	1
カス梦名	찌꺼기	1
カンケー梦名	관계	1
カンスト梦名	카운터스톱	1	//
ガセ梦名	엉터리	1
キズナ梦名	인연	1
シカト梦名	무시	1	//俺はシカトでも菜桜子には答えるのかよ……。
タライ梦名	대야	1
ダメモト梦名	밑져야 본전	1
ツテ梦名	연줄	1
ツバ梦名	침	1
トゲ梦名	가시	1
ハッタリ梦名	허세	1
パウダー梦名	파우더	1
トリハダ梦名	소름	1
ヒダ梦名	주름	1
ビンタ梦名	귀싸대기	1
ヘドロ梦名	진흙탕	1
マッパ梦名	알몸	1
メンテ梦名	메인터넌스	1
ワンチャン梦名	원 찬스	1
イチ部分梦名	제일 중요한 부분	1
ケー番梦名	폰번	1
モヤ梦名	안개	1
ファンデ梦名	파운데이션	1
メシベ梦名	암술	1
オシベ梦名	수술	1
ツッパリ梦名	버팀목	1
チンカス梦名	좆밥	1
ツンケン梦名	뾰루퉁	1	//なんでそんなにツンケンしてるのさー。
カン蹴り梦名	깡통차기	1
ワン切り梦名	원링 스팸	1
モモ肉梦名	다리살	1	//もも肉
ホウキ梦名	빗자루	1
コスパ梦名	가성비	1
一体梦名	일체[一體]	1
//
眦梦名	눈꼬리	1
鰭梦名	지느러미	1
年梦名	나이	1
鼾梦名	코골이	1
鎌梦名	낫	1
蕾梦名	꽃봉오리	1
髭梦名	수염	1
髭梦名もじゃ	수염투성이	1	UYh	// :인간&동물 외적 형용 髭もじゃ
屁梦名	방귀	1
瑕梦名	티[瑕]	1
お縄梦名	포박[お繩]	1
塀梦名	담	1
雫梦名	물방울	1
素の状態梦名	본연의 상태	1
骸梦名	사체	1
紙の上梦名	종이 위	1
紙の下梦名	종이 아래	1
酌梦名	잔	1
籠梦名	바구니	1
贄梦名	제물	1
楔梦名	쐐기	1	VPe	// :도구
貌梦名	용모	1
盆梦名	쟁반	1
睫梦名	속눈썹	1
歩梦名	걸음	1	//歩を進める毎にその音は
棘梦名	가시	1	//棘のある声
棘梦名の髪	헝클어진 머리	1	//棘の髪
了解梦名	양해[了解]	1
手形梦名	손도장	1
女手形梦名	여자 손도장	1
天梦名	하늘	1	//今日も暖かき天からの恵を与えた
恋話梦名	사랑 이야기	1
恋バナ梦名	사랑 이야기	1
パンモロ梦名	팬티 보임	1
三家梦名	세 가문	1
雹梦名	우박	1
椀梦名	밥공기	1
ダンマリ梦名	침묵	1
写メ梦名	휴대폰 사진	1
外ヅラ	밖에서의 인상	1	//外ヅラのいい。
大アリ梦名	많이 있음	1	//こっちは大アリだ。
大アリッ梦名	많이 있음	1	//こっちは大アリッ。
すり傷梦名	스친 상처	1
壁ドン梦名	벽 꽝[壁ドン]	1	//남성이 여성을 벽에 밀어붙이고 한쪽 손으로 벽을 쾅 치는 행위.
壁ドンッ梦名	벽 꽝[壁ドン]	1	//남성이 여성을 벽에 밀어붙이고 한쪽 손으로 벽을 쾅 치는 행위.
水の上梦名	물 위	1
二言梦名	두 말	1
運休梦名	운휴[運休]	1
長居梦名	오래 머무르기	1	//長居をする
道行梦名	도행[道行き]	1	//道行き
膝上梦名	무릎 위	1	//膝上２０センチ
中の上梦名	중상[中の上]	1
中の中梦名	중간[中の中]	1
中の下梦名	중하[中の下]	1
ひとつ上梦名	하나 위	1
蛇口梦名	수도꼭지	1	//洗濯機の上に蛇口がついてる。
背たけ梦名	신장	1
貝殻梦名	조개 껍질	1	//貝殻について調べてる。貝殻についている
何カップ梦名	무슨 컵	1
オジャン梦名	허사	1
格上梦名	격상	1
万死梦名	만번 죽음	1	//万死に値する。
変顔梦名	우스운 얼굴	1
字面梦名	자면[字面]	1
メス化梦名	암컷화	1
薪梦名	장작	1
樽梦名	통	1
あと少し梦名	앞으로 조금	1	//あと少し : あと少しね。あと少しよ。あと少しでも 등 활용이 너무 안 돼서 포함시켰음.
後少し梦名	앞으로 조금	1
毎日梦名	매일	1	//花には毎日、水が必要
人並み梦名	남들 수준	1
人並梦名	남들 수준	1
やり込み梦名	파고들기[やり℡입み]	1
引引き梦名	당김[引き]	1
シメ方梦名	끝내는 법[シメ方]	1

//+.
//수사 관련
何戰枚目	몇 장째	1	//何枚目
幾戰枚目	몇 장째	1	//幾枚目
戰枚目	@@장째	1	//二枚目
何戰年目	몇 년째	1	//何年目
幾戰年目	몇 년째	1	//幾年目
戰年目	@@년째	1	//五二年目。五年目。何年目。幾年目。
何戰周目	몇 주째	1	//何周目
幾戰周目	몇 주째	1	//幾周目
戰周目	@@주째	1	//二周目も。五周目。何周目。幾周目。
何戰日目	몇 일째	1	//何日目
幾戰日目	몇 일째	1	//幾日目
戰日目	@@일째	1	//二日目。五日目。何日目。幾日目。
何戰分目	몇 분째	1	//何分目
幾戰分目	몇 분째	1	//幾分目
戰分目	@@분째	1	//二分目。五分目。何分目。幾分目。
何戰本目	몇 개째	1	//何本目
幾戰本目	몇 개째	1	//幾本目
戰本目	@@개째	1	//二本目。五本目。何本目。幾本目。
何戰度目	몇 번째	1	//何度目
幾戰度目	몇 번째	1	//幾度目
戰度目	@@번째	1	//二度目。五度目。何度目。幾度目。
何戰歩目	몇 걸음째	1	//何歩目
幾戰歩目	몇 걸음째	1	//幾歩目
戰歩目	@@걸음째	1	//１歩目。
何戰杯目	몇 잔째	1	//何杯目
幾戰杯目	몇 잔째	1	//幾杯目
戰杯目	@@잔째	1	//二杯目。五杯目。何杯目。幾杯目。
何戰口目	몇 입째	1	//何口目
幾戰口目	몇 입째	1	//幾口目
戰口目	@@입째	1	//二口目。五口目。何口目。幾口目。
何戰回目	몇 회째	1	//何回目
幾戰回目	몇 회째	1	//幾回目
戰回目	@@회째	1	//二回目。五回目。何回目。幾回目。
何戰撃目	몇 격째	1	//何撃目
幾戰撃目	몇 격째	1	//幾撃目
戰撃目	@@격째	1	//二撃目。五撃目。何撃目。幾撃目。
何戰発目	몇 발째	1	//何発目
幾戰発目	몇 발째	1	//幾発目
戰発目	@@발째	1	//二発目。五発目。何発目。幾発目。
何戰合目	몇 합째	1	//何合目
幾戰合目	몇 합째	1	//幾合目
戰合目	@@합째	1	//二合目。五合目。何合目。幾合目。
何戰点目	몇 점째	1	//何点目
幾戰点目	몇 점째	1	//幾点目
戰点目	@@점째	1	//二点目。五点目。何点目。幾点目。
何戰限目	몇 교시째	1	//何限目
幾戰限目	몇 교시째	1	//幾限目
戰限目	@@교시째	1	//二限目。五限目。何限目。幾限目。
何戰件目	몇 건째	1	//何件目
幾戰件目	몇 건째	1	//幾件目
戰件目	@@건째	1	//二件目。五件目。何件目。幾件目。
何戰人目	몇 인째	1	//何人目
幾戰人目	몇 인째	1	//幾人目
戰人目	@@인째	1	//二人目。五人目。何人目。幾人目。
何戰代目	몇 대째	1	//何代目
幾戰代目	몇 대째	1	//幾代目
戰代目	@@대째	1	//二代目。五代目。何代目。幾代目。
何戰手目	몇 수째	1	//何手目
幾戰手目	몇 수째	1	//幾手目
戰手目	@@수째	1	//二手目。
何戰時間目	몇 시간째	1	//何時間目
幾戰時間目	몇 시간째	1	//幾時間目
戰時間目	@@시간째	1	//二時間目。五時間目。何時間目。幾時間目。
何戰時限目	몇 교시째	1	//何時限目
幾戰時限目	몇 교시째	1	//幾時限目
戰時限目	@@교시째	1	//二時限目。五時限目。何時限目。幾時限目。
何戰ターン目	몇 턴째	1	//何ターン目
幾戰ターン目	몇 턴째	1	//幾ターン目
戰ターン目	@@턴째	1	//２ターン目から
何戰色	무슨 색	1	//何色。
幾戰色	몇 색	1	//幾色。
戰色	@@색	1	//二色。五色。
何戰文字	무슨 문자	1	//何文字。
幾戰文字	몇 문자	1	//幾文字。
戰文字	@@문자	1	//二文字。五文字。
何戰人組	몇 인조	1	//何人組
幾戰人組	몇 인조	1	//幾人組
戰人組	@@인조	1	//二人組。五人組。何人組。幾人組。
何戰連撃	몇 연격	1	//何連撃
幾戰連撃	몇 연격	1	//幾連撃
戰連撃	@@연격	1	//疾風三連撃。
何戰人前	몇 인분	1	//何人前
幾戰人前	몇 인분	1	//幾人前
戰人前	@@인분	1	//五人前を。
何戰名様	몇 분	1	//何名様
幾戰名様	몇 분	1	//幾名様
戰名様	@@분	1	//六名様ご来店です。
何戰戦目	몇 전째	1	//何戦目
幾戰戦目	몇 전째	1	//幾戦目
戰戦目	@@전째	1	//三戦目
何戰射目	몇 사째	1	//何射目
幾戰射目	몇 사째	1	//幾射目
戰射目	@@사째	1	//二射目は、見えた。
何戰段目	몇 단째	1	//何段目
幾戰段目	몇 단째	1	//幾段目
戰段目	@@단째	1	//三段目
何戰匹目	몇 마리째	1	//何匹目
幾戰匹目	몇 마리째	1	//幾匹目
戰匹目	@@마리째	1	//一匹目
何戰人組み	몇 인조	1	//何人組み
幾戰人組み	몇 인조	1	//幾人組み
戰人組み	@@인조	1	//二人組。五人組。何人組。幾人組。
何戰代前	몇 대전	1	//何代前
幾戰代前	몇 대전	1	//幾代前
戰代前	@@대전	1	//二代前。五代前。何代前。幾代前。
何戰箇所	몇 개소	1	//何箇所
幾戰箇所	몇 개소	1	//幾箇所
戰箇所	@@개소	1	//二箇所も。五箇所。何箇所。幾箇所。
何戰階級	몇 계급	1	//何階級
幾戰階級	몇 계급	1	//幾階級
戰階級	@@계급	1	//二階級。五階級。何階級。幾階級。
何戰世紀	몇 세기	1	//何世紀
幾戰世紀	몇 세기	1	//幾世紀
戰世紀	@@세기	1	//二世紀。五世紀。何世紀。幾世紀。
何戰科目	몇 과목	1	//何科目
幾戰科目	몇 과목	1	//幾科目
戰科目	@@과목	1	//六科目
何戰回り	몇 바퀴	1	//何回り
幾戰回り	몇 바퀴	1	//幾回り
戰回り	@@바퀴	1	//
何戰体目	몇 체째	1
幾戰体目	몇 체째	1
戰体目	@@체째	1
何戰スレ目	몇 스레째	1
幾戰スレ目	몇 스레째	1
戰スレ目	@@스레째	1
何戰件	몇 건	1	//何件
幾戰件	몇 건	1	//幾件
戰件	@@건	1	//殺人罪一二件
//
戰万石	@@만석	1
戰千石	@@천석	1
戰萬石	@@만석	1
戰限	@@교시	1	//一限, 二限
正一戰位	정 1위	1
正二戰位	정 2위	1
正三戰位	정 3위	1
正四戰位	정 4위	1
正五戰位	정 5위	1
正六戰位	정 6위	1
正七戰位	정 7위	1
正八戰位	정 8위	1
正九戰位	정 9위	1
従一戰位	종 1위	1
従二戰位	종 2위	1
従三戰位	종 3위	1
従四戰位	종 4위	1
従五戰位	종 5위	1
従六戰位	종 6위	1
従七戰位	종 7위	1
従八戰位	종 8위	1
従九戰位	종 9위	1
戰位	@@위	1	//ランキング戦で十六位ぐらい。
//
戰人用	@@인용	1	//三人がけの椅子。

//동사 관련
お分かり梦名	알고 계심お_敬	1
おわかり梦名	알고 계심お_敬	1
お知り梦名	알고 계심お_敬	1
お有り梦名	있으심お_敬	1
おあり梦名	있으심お_敬	1
お呼び梦名	부르심お_敬	1
お忘れ梦名	잊으심お_敬	1	//もしかしてお忘れだったんですか？
お聞き梦名	(들)물으심お_敬	1

//する
//▂1
首に戰戰	≪해고ㅎㅏㄴ∬&≫	0	//
唾戰戰	≪침뱉ㄴㅡㄴ∬&≫	0	//唾する(つばきする) : 天に唾する者は、必ず報いを受ける。
頬ずり戰戰	≪뺨을 비ㅂㅣㄴ∬&≫	0	//頬ずりする (あご) : 頬ずりしまくる。頬ずりしすぎる。頬ずりになる。
頬擦り戰戰	≪뺨을 비ㅂㅣㄴ∬&≫	0	//頬擦りする
一瞥戰戰	≪슬쩍 ㅂㅗㄴ∬&≫	0	//一瞥する (いちべつ) : 一瞥しまくる。一瞥しすぎる。一瞥になる。
苛立ち戰戰	≪초조ㅎㅏㄴ∬&≫	0	//苛立ちしながら (いらだち) : 苛立ちしまくる。苛立ちしすぎる。苛立ちになる。
うっかり戰戰	≪깜빡&≫	0	//うっかりする。うっかりしすぎる。
蔑ろに戰戰	≪업신여ㄱㅣㄴ∬&≫	0	//蔑ろにした (う) : 蔑ろにされる。蔑ろにしまくる。蔑ろにしすぎる。蔑ろになる。
餌付け戰戰	≪길들ㅇㅣㄴ∬&≫	0	//餌付けする (えづけ)
公戰戰	≪공공연&≫	0	//公にする (おおやけに)。公になる
おしゃぶり戰戰	≪ㅃㅏㄹ∬&≫	0	//おしゃぶりするつもり
おねだり戰戰	≪졸라ㄷㅐㄴ∬&≫	0	//おねだりしまくる。おねだりしすぎる。上手におねだり出来たな。おねだりになる。
開口戰戰	≪개구[開口]&≫	0	//開口する　(かいこう)
火傷戰戰	≪화상 입ㄴㅡㄴ∬&≫	0	//火傷する (かいしょう)
火傷を戰戰	≪화상을 입ㄴㅡㄴ∬&≫	0	//火傷をする (かいしょう)
観念戰戰	≪체념ㅎㅏㄴ∬&≫	0	//観念した (かんねん) : 観念しまくる。観念しすぎる。観念させる。(x)観念になる。
ガン見戰戰	≪뚫어지게 ㅂㅗㄴ∬&≫	0	//ガン見する。ガン見される
着やせ戰戰	≪옷 입으면 날씬ㅎㅏㄴ∬&≫	0	//着やせする
着痩せ戰戰	≪옷 입으면 날씬ㅎㅏㄴ∬&≫	0	//着痩せする
擬戰戰	≪겨ㄴㅜㄴ∬&≫	0	//擬する(ぎする)。擬しすぎる。
釘付けに戰戰	≪못박ㄴㅡㄴ∬&≫	0	//敵を釘付けにする。(くぎずけ) 名画の前に釘付けになる
苦笑戰戰	≪쓴웃음 ㅈㅣㅅㄴㅡㄴ∬&≫	0	//苦笑する (くしょう) : 苦笑しまくる。苦笑しすぎた。苦笑になる。
苦笑を戰戰	≪쓴웃음을 ㅈㅣㅅㄴㅡㄴ∬&≫	0	//苦笑をする
与戰戰	≪가담&≫	0	//与する(くみする)
与ァ戰戰	≪상대&≫	0	//与し易い
恋戰戰	≪사랑&≫	0	//恋する(こいそる) : 恋しない。恋しなさい
黙戰戰	≪침묵&≫	0	//黙する(むくそる) : それきり黙した桜守姫さんは
留め戰戰	≪고정&≫	0	//留めする(とめそる) : まずはピンで留めするところからだよ。ピン留めしたいページを表示し。
こけに戰戰	≪바보로##&≫	0	//おれをこけにする。
コケに戰戰	≪바보로##&≫	0	//コケにする。コケにされる。コケにさせる。
ご馳走戰戰	≪대접&≫	0	//ご馳走する (ごちそう) : お茶ぐらいご馳走するからさ。
御馳走戰戰	≪대접&≫	0	//御馳走する (ごちそう) : お茶ぐらい御馳走するからさ。
祝戰戰	≪축하&≫	0	//祝する (しゅくする)
逡巡戰戰	≪망설ㅇㅣㄴ∬&≫	0	//逡巡する (しゅんじゅん) : 逡巡になる。
スルー戰戰	≪무시ㅎㅏㄴ∬&≫	0	//スルーする : この重要な経験をスルーしていた。
ズル戰戰	≪비겁한 짓&≫	0	//ズルする : ズルしてたんだから。
清々戰戰	≪시원&≫	0	//清々する (せいせい) : 清々しまくる。清々しすぎる。清々になる。
咀嚼戰戰	≪음미ㅎㅏㄴ∬&≫	0	//咀嚼する (そしゃく)
楚々戰戰	≪청초ㅎㅏㄴ∬&≫	0	//楚々した姿 (そそ)
転校戰戰	≪전학&≫	0	//転校する (てんこう) : 転校してきたすっごい美人の子
長居戰戰	≪오래 머무ㄹㅡㄴ∬&≫	0	//長居する。長居させる
//長居を戰戰	≪오래 머무르기를 ㅎㅏㄴ∬&≫	0	//長居をする
猫被り戰戰	≪내숭 ㄸㅓㄹ∬&≫	0	//猫被りする (ねこかぶり) : 猫被りしまくる。猫被りしすぎた。猫被りになる。
猫被りを戰戰	≪내숭을 ㄸㅓㄹ∬&≫	0	//猫被りをする
歯軋り戰戰	≪이를 ㄱㅏㄹ∬&≫	0	//歯軋りする。
歯ぎしり戰戰	≪이를 ㄱㅏㄹ∬&≫	0	//歯ぎしりする。
腹ごしらえ戰戰	≪배를 채ㅇㅜㄴ∬&≫	0	//ちょっと腹ごしらえしとくか。
腹拵え戰戰	≪배를 채ㅇㅜㄴ∬&≫	0	//ちょっと腹拵えしとくか。
罰戰戰	≪벌ㅎㅏㄴ∬&≫	0	//罰する (ばつする) : "처벌한다"를 "벌한다"로 바꾸기 위함. 罰する。罰される。罰させる。
暇戰戰	≪한가ㅎㅏㄴ∬&≫	0	//暇する (ひまする) : 暇しまくる。暇しすぎる。暇になる。暇してブラブラしてる
御戰戰	≪잘 다ㄹㅜㄴ∬&≫	0	//御する (ぎょする) : これならベルセルクの細胞を御することも出来るだろうし……
びっくり戰戰	≪깜짝 놀ㄹㅏㄴ∬&≫	0	//びっくりさせる
貶戰戰	≪폄하ㅎㅏㄴ∬&≫	0	//貶する (へんする) : 貶させる。貶される。貶させすぎる。
併走戰戰	≪나란히 달ㄹㅣㄴ∬&≫	0	//併走する (へいそう) : 併走しまくる。併走しすぎる。併走になる。
並走戰戰	≪나란히 달ㄹㅣㄴ∬&≫	0	//並走する (へいそう) : 並走しまくる。並走しすぎる。並走になる。
翻弄戰戰	≪희롱ㅎㅏㄴ∬&≫	0	//翻弄する (ほんろう)
丸写し戰戰	≪그대로 베ㄲㅣㄴ∬&≫	0	//丸写しする (まるうつし) : 丸写ししまくる。丸写ししすぎる。(x)丸写しになる。
迷惑戰戰	≪폐 끼ㅊㅣㄴ∬&≫	0	//迷惑する、
迷惑を戰戰	≪폐를 끼ㅊㅣㄴ∬&≫	0	//迷惑をされる
悶悶戰戰	≪번민&≫	0	//悶悶しているせいか？
悶々戰戰	≪번민&≫	0	//悶々しているせいか？
もんもん戰戰	≪번민&≫	0	//もんもんしているせいか？
モンモン戰戰	≪번민&≫	0	//モンモンしているせいか？
痩せ我慢戰戰	≪오기 부ㄹㅣㄴ∬&≫	0	//痩せ我慢してねぇで、
痩せ我慢は戰戰	≪오기는 부ㄹㅣㄴ∬&≫	0	//痩せ我慢はする
やせ我慢戰戰	≪오기 부ㄹㅣㄴ∬&≫	0	//やせ我慢してねぇで、
やせ我慢は戰戰	≪오기는 부ㄹㅣㄴ∬&≫	0	//やせ我慢はする
ヤセ我慢戰戰	≪오기 부ㄹㅣㄴ∬&≫	0	//ヤセ我慢してねぇで、
ヤセ我慢は戰戰	≪오기는 부ㄹㅣㄴ∬&≫	0	//ヤセ我慢はする
ヤセがまん戰戰	≪오기 부ㄹㅣㄴ∬&≫	0	//ヤセがまんしてねぇで、
ヤセがまんは戰戰	≪오기는 부ㄹㅣㄴ∬&≫	0	//ヤセがまんはする
悪乗り戰戰	≪덩달아 분위기 ㅌㅏㄴ∬&≫	0	//これから紹介する写真はちょっと悪ノリした愛すべきおバカさんたちです。
悪のり戰戰	≪덩달아 분위기 ㅌㅏㄴ∬&≫	0	//これから紹介する写真はちょっと悪ノリした愛すべきおバカさんたちです。
悪ノリ戰戰	≪덩달아 분위기 ㅌㅏㄴ∬&≫	0	//これから紹介する写真はちょっと悪ノリした愛すべきおバカさんたちです。
ノビ戰戰	≪기지개 ㅋㅕㄴ∬&≫	0	//ノビするよね。
お下げ戰戰	≪ㅊㅣ_ㅇㅜㄴ∬&≫	0	//お下げします。
お暇戰戰	≪ㄸㅓ_ㄴㅏㄴ∬&≫	0	//お暇しようかしら。
まっとう戰戰	≪완수&≫	0	//まっとうして。
腕組み戰戰	≪팔짱 ㄲㅣㄴ∬&≫	0	//腕組みする。
腕くみ戰戰	≪팔짱 ㄲㅣㄴ∬&≫	0	//腕くみする。
腕ぐみ戰戰	≪팔짱 ㄲㅣㄴ∬&≫	0	//渚は腕ぐみしたまま
彷彿と戰戰	≪방불케 &≫	0	//さながら焼きたてパンを彷彿とさせる弾力が、
マッチ戰戰	≪매치&≫	0	//慶司の服装とマッチさせることも重要！
愛想尽し戰戰	≪쌀쌀한 태도 취ㅎㅏㄴ∬&≫	0	//愛想尽しされる。
愛想尽かし戰戰	≪쌀쌀한 태도 취ㅎㅏㄴ∬&≫	0	//愛想尽かしされる。
愛想尽しを戰戰	≪쌀쌀한 태도를 취ㅎㅏㄴ∬&≫	0	//愛想尽しをする。
愛想尽かしを戰戰	≪쌀쌀한 태도를 취ㅎㅏㄴ∬&≫	0	//愛想尽かしをする。
あいそづかし戰戰	≪쌀쌀한 태도 취ㅎㅏㄴ∬&≫	0	//あいそづかしする。
あいそづかしを戰戰	≪쌀쌀한 태도를 취ㅎㅏㄴ∬&≫	0	//あいそづかしをする。
楽が戰戰	≪편안하게 ㅎㅏㄴ∬&≫	0	//楽ができる。
楽を戰戰	≪편안히 ㅎㅏㄴ∬&≫	0	//楽をする為の道具ではないよ。楽をさせてもらったから。
楽戰戰	≪편해ㅈㅣㄴ∬&≫	0	//楽したい
冠戰戰	≪씌ㅇㅜㄴ∬&≫	0	//魔王の名が冠された理由
チラ見戰戰	≪살짝 ㅂㅗㄴ∬&≫	0	//チラ見する
気乗りが戰戰	≪마음이 내ㅋㅣㄴ∬&≫	0	//気乗りがする
気のりが戰戰	≪마음이 내ㅋㅣㄴ∬&≫	0	//
気乗り戰戰	≪마음 내ㅋㅣㄴ∬&≫	0	//気乗りする
気のり戰戰	≪마음 내ㅋㅣㄴ∬&≫	0	//
ブチキレ戰戰	≪폭발ㅎㅏㄴ∬&≫	0	//ブチキレする
ブチ切れ	≪폭발ㅎㅏㄴ∬&≫	0	//ブチ切れする
ブッチ戰戰	≪ㄲㅐㄴ∬&≫	0	//親の葬式をブッチして
増長戰戰	≪늘어ㄴㅏㄴ∬&≫	0	//増長して
大振り戰戰	≪크게 휘두ㄹㅡㄴ∬&≫	0	//大振りする
辟易戰戰	≪물러ㄴㅏㄴ∬&≫	0	//辟易する
辟易と戰戰	≪난처해ㅎㅏㄴ∬&≫	0	//辟易とする
ぶつ切りに戰戰	≪토막ㅊㅣㄴ∬&≫	0	//ぶつ切りにする
遇戰戰	≪대접&≫	0	//遇される。
見向きは戰戰	≪되돌아는 ㅂㅗㄴ∬&≫	0	//見向きはしたけど、追いかけてまで食べようという気持ちはないらしい。
見向きも戰戰	≪거들떠도 ㅂㅗㄴ∬&≫	0	//見向きもせず。見向きもされない。見向きもされなくなる。
耄碌戰戰	≪망령 ㄴㅏㄴ∬&≫	0	//耄碌する
遠慮でも戰戰	≪사양이라도 &≫	0	//遠慮でもしていたのか
感じ戰戰	≪느낌 ㄷㅡㄹ∬&≫	0	//なんかちょっとやな感じするけど
感じは戰戰	≪느낌은 ㄷㅡㄹ∬&≫	0	//感じはして
感じも戰戰	≪느낌도 ㄷㅡㄹ∬&≫	0	//感じもして
持ち逃げ戰戰	≪들고 도망ㅊㅣㄴ∬&≫	0	//持ち逃げされる
討ち死に戰戰	≪전사ㅎㅏㄴ∬&≫	0	//討ち死にした
//お仕置き戰戰	≪벌 받ㄴㅡㄴ∬&≫	0	//お仕置きされ
仰天戰戰	≪놀ㄹㅏㄴ∬&≫	0	//仰天した
睥睨戰戰	≪흘겨ㅂㅗㄴ∬&≫	0	//睥睨した
律戰戰	≪규율ㅎㅏㄴ∬&≫	0	//自分を律する機能
嘉戰戰	≪가상히 여ㄱㅣㄴ∬&≫	0	//長坂一人を神様が嘉したかのようで。志を嘉する。
つま弾戰戰	≪튕ㄱㅣㄴ∬&≫	0	//つま弾する
お茶に戰戰	≪차 한 잔 ㅎㅏㄴ∬&≫	0	//お茶にする。
お茶戰戰	≪차 한 잔 ㅎㅏㄴ∬&≫	0	//お茶する
匂梦戰戰	≪냄새 ㄴㅏㄴ∬&≫	0	//変な臭いしませんか？
匂梦が戰戰	≪냄새가 ㄴㅏㄴ∬&≫	0	//変な臭いがしませんか？
匂梦は戰戰	≪냄새는 ㄴㅏㄴ∬&≫	0	//変な臭いはしませんか？
匂梦も戰戰	≪냄새도 ㄴㅏㄴ∬&≫	0	//変な臭いもしませんか？
臭が戰戰	≪냄새가 ㄴㅏㄴ∬&≫	0	//犯罪臭がするよ・・・
臭は戰戰	≪냄새는 ㄴㅏㄴ∬&≫	0	//臭はするよ・・・
臭も戰戰	≪냄새도 ㄴㅏㄴ∬&≫	0	//
ケチケチ戰戰	≪쩨쩨하게 ㅎㅏㄴ∬&≫	0	//ケチケチするんじゃないわよ
物怖じ戰戰	≪겁먹ㄴㅡㄴ∬&≫	0	//物怖じしない
策を弄戰戰	≪술책을 부ㄹㅣㄴ∬&≫	0	//策を弄されする
日持ち戰戰	≪장기 보존 가능ㅎㅏㄴ∬&≫	0	//日持ちするかどうか確認するため
日持ちが戰戰	≪장기 보존이 가능ㅎㅏㄴ∬&≫	0	//
日持ちは戰戰	≪장기 보존은 가능ㅎㅏㄴ∬&≫	0	//日持ちはするかどうか確認するため
日持ちも戰戰	≪장기 보존도 가능ㅎㅏㄴ∬&≫	0	//
歯がみ戰戰	≪이를 ㄱㅏㄹ∬&≫	0	//歯がみしていた女性が
お酌梦名を戰戰	≪잔을 ㄸㅏ_ㄹㅡㄴ∬&≫	0	//お酌をする
世間擦れ戰戰	≪닳고 닳ㄴㅡㄴ∬&≫	0	//世間擦れしていない女
世間ずれ戰戰	≪닳고 닳ㄴㅡㄴ∬&≫	0	//
とんずら戰戰	≪도망ㅊㅣㄴ∬&≫	0	//とんずらする
トンズラ戰戰	≪도망ㅊㅣㄴ∬&≫	0	//トンズラする
屯戰戰	≪모ㅇㅣㄴ∬&≫	0	//屯する
圧戰戰	≪ㄴㅜ_ㄹㅡㄴ∬&≫	0	//圧され
又聞き戰戰	≪전해 ㄷㅡㄷㄴㅡㄴ∬&≫	0	//私が又聞きしている彼の人生は
去来戰戰	≪오고 ㄱㅏㄴ∬&≫	0	//頭の中に幾つもの記憶の欠片が去来する。
浮き彫りに戰戰	≪부각되게 ㅎㅏㄴ∬&≫	0	//浮き彫りにする
浮きぼりに戰戰	≪부각되게 ㅎㅏㄴ∬&≫	0	//浮き彫りにする
底光り戰戰	≪그윽하게 빛ㄴㅏㄴ∬&≫	0	//師匠の底光りする瞳だった。
底光りが戰戰	≪그윽하게 빛이 ㄴㅏㄴ∬&≫	0	//
底光りの戰戰	≪그윽하게 빛ㄴㅏㄴ∬&≫	0	//
無碍に戰戰	≪헛되게 ㅎㅏㄴ∬&≫	0	//無碍にする
化粧映え戰戰	≪화장발 받ㄴㅡㄴ∬&≫	0	//化粧映えする
化粧映えの戰戰	≪화장발이 받ㄴㅡㄴ∬&≫	0	//化粧映えのする
化粧映えが戰戰	≪화장발이 받ㄴㅡㄴ∬&≫	0	//化粧映えがする
化粧映えは戰戰	≪화장발은 받ㄴㅡㄴ∬&≫	0	//化粧映えはする
化粧映えも戰戰	≪화장발도 받ㄴㅡㄴ∬&≫	0	//化粧映えもしない
横取り戰戰	≪가로ㅊㅐㄴ∬&≫	0	//獲物が横取りされてしまうぞ
串刺しに戰戰	≪꿰뚫ㄹㅣㄴ∬&≫	0	//上下の穴を串刺しにされ
雁字搦めに戰戰	≪얽어ㅁㅐㄴ∬&≫	0	//言葉そのもので聞き手を雁字搦めにする
大笑い戰戰	≪박장대소 ㅎㅏㄴ∬&≫	0	//二人で大笑いしていた。
カモに戰戰	≪호구 취급ㅎㅏㄴ∬&≫	0	//駆け出しのころは散々カモにされたよ
お会い戰戰	≪만나ㅂㅚ_∬&≫	0	//お会いするのは初めてでございますね
まる飲み戰戰	≪통째로 삼ㅋㅣㄴ∬&≫	0	//まる飲みすると逆効果になります
丸飲み戰戰	≪통째로 삼ㅋㅣㄴ∬&≫	0	//
//▂2
お聞きは戰戰	≪듣기는 ㅎㅏㄴ∬&≫	0	//お聞きはしますが。
気づき戰戰	≪눈치ㅊㅐㄴ∬&≫	0	//お気づきする
気づきは戰戰	≪눈치는 ㅊㅐㄴ∬&≫	0	//お気づきはする
気づきも戰戰	≪눈치도 ㅊㅐㄴ∬&≫	0	//お気づきもする
気づきを戰戰	≪눈치를 ㅊㅐㄴ∬&≫	0	//お気づきをする
お連れ戰戰	≪동반&≫	0	//お連れする
お手伝い戰戰	≪ㄷㅗㅂㄴㅡㄴ∬&≫	0	//お手伝いいたします。
手伝い戰戰	≪ㄷㅗㅂㄴㅡㄴ∬&≫	0	//手伝いいたします。
お任せ戰戰	≪맡ㄱㅣㄴ∬&≫	0	//お任せ致します
お守り戰戰	≪수호&≫	0	//お守りしたいと思います。お守り致します。
お付け戰戰	≪붙여 드ㄹㅣㄴ∬&≫	0	//カバーをお付けしてもよろしいですか。
おつけ戰戰	≪붙여 드ㄹㅣㄴ∬&≫	0	//お客様には特別にタルエムの小箱もおつけいたします。
//▂3
閑散と戰戰	≪한산ㅎㅏㄴ∬&≫	0	//閑散とする (かんさん) : 閑散としまくる。閑散としすぎる。閑散とされる。閑散となる。
ぐったりと戰戰	≪축 늘어ㅈㅣㄴ∬&≫	0	//ぐったりとする。ぐったりとなる。ぐったりとさせる。ぐったりとされる。ぐったりとなさる。ぐったりとして。
グッタリと戰戰	≪축 늘어ㅈㅣㄴ∬&≫	0	//グッタリとする。グッタリとなる。グッタリとさせる。グッタリとされる。グッタリとなさる。グッタリとして。
凛と戰戰	≪늠름ㅎㅏㄴ∬&≫	0	//凛とした (りん) : 凛としまくる。凛としすぎる。
振り向き戰戰	≪뒤돌아 ㅂㅗㄴ∬&≫	0	//振り向きする
振り向きも戰戰	≪뒤돌아 보기도 ㅎㅏㄴ∬&≫	0	//振り向きもせず
振り向きは戰戰	≪뒤돌아 보기는 ㅎㅏㄴ∬&≫	0	//振り向きはしたが

//+.
早きに戰戰	너무 일러 시기를	0	//早きに失する。
遅きに戰戰	너무 늦어 시기를	0	//遅きに失したが。


//동사 + はする : "~기" 형태로 입력해야 함.
会い戰	만나기	1	//会いはする
聞き戰	(듣)묻기	1	//聞きはする
届き戰	닿기	1	//粗末な哀願は届きもしなかった。
載り戰	실리기	1	//新聞に載りでもしたら。
困り戰	곤란하기	1	//困りはしません。
わかり戰	알기	1	//わかりはする
分かり戰	알기	1	//分かりはする
勝て戰	이기기	1	//勝てはする
かすり戰	스치기	1	//そんな単調な攻撃ではかすりもしないし、
知り戰	알기	1	//知りもしない。
叶い戰	실현되기	1
厭い戰	싫어하기	1	//厭いはしない。
狂い戰	미치기	1	//厭いはしない。狂いなどしない。
戰あり戰	있기	1
戰有り戰	있기	1
戰引き戰	당기기	1
戰なり戰	되기	1
離し戰	떼어놓기	1	//もうこれ以上離しはしない
続き戰	계속되기	1	//そう続きはしない。
掠り戰	스치기	1	//爪熊の爪は掠りもせず、
忘れ戰	잊기	1	//忘れもしない。
目立ち戰	눈에 띄기	1	//目立ちはしないが渋く光る食事処かな。
役に立ち戰	도움이 되기	1	//役に立ちはしないのであった。
出見来戰	할 수 있기	1	//
見え戰	보이기	1	//姿も見えはしない

//極まる 관련
愚かヶ	어리석기	1
痛快ヶ	통쾌하기	1
無礼ヶ	무례하기	1
狡獪ヶ	교활하기	1
危険ヶ	위험하기	1
不快ヶ	불쾌하기	1
巧妙ヶ	교묘하기	1
不都合ヶ	부적절하기	1
理不尽ヶ	불합리하기	1
異常ヶ	이상하기	1
無残ヶ	무참하기	1
凄惨ヶ	처참하기	1
面倒ヶ	귀찮기	1
迷惑ヶ	민폐스럽기	1
重厚ヶ	중후하기	1
陰湿ヶ	음습하기	1
心外ヶ	뜻밖이기	1
愉快ヶ	유쾌하기	1
凶悪ヶ	흉악하기	1
不愉快ヶ	불쾌하기	1
ふしだらヶ	단정치 못하기	1	//ふしだら極まる。

//'동사의 명사형
人食い梦名	식인	1	//人食い
悼みっぷり	애도하는 모습	1	//생성동사+っぷり형.
尊びっぷり	존경하는 모습	1	//생성동사+っぷり형.
占めっぷり	차지하는 모습	1
遮りっぷり	차단하는 모습	1
歌いっぷり	노래하는 모습	1
ふせぎっぷり	방지하는 모습	1
耕しっぷり	경작하는 모습	1
放ちっぷり	발하는 모습	1

//さ
間抜けさ梦名	덜 떨어짐	1	UYi	// :인간&동물 내적 형용 アタシの間抜けさでも笑うといいじゃねーか
強かさ梦名	만만찮음	1	//強かさが滲み出るような笑いだった。
強引さ梦名	강행함	1	//「いや、いいよ……その強引さが嬉しかった……」

//ヶ를 붙인 と'부사 (필터링)
//(て는 ッて 만 하기로)
ヶカクンと	달칵	0	//カクンと
ヶカクンーと	달-칵	0	//カクンーと
ヶカクンッと	달칵	0	//カクンッと
ヶカクンッて	달칵	0	//カクンッて
ヶカクンッーと	달-칵	0	//カクンッーと
ヶキッと	홱	0	//キッと
ヶキッて	홱	0	//キッて
ヶキッーと	홱-	0	//キッーと
ヶキリッと	늠름	0	//キリッと
ヶキリッて	키릿	0	//キリッて
ヶキリッーと	키-릿	0	//キリッーと
ヶキュッと	꽉	0	//キュッと
ヶキュッて	꽉	0	//キュッて
ヶキュッーと	꽉-	0	//キュッーと
ヶキュンと	뜨끔	0	//キュンと
ヶキュンーと	뜨-끔	0	//キュンーと
ヶキュンッと	뜨끔	0	//キュンッと
ヶキュンッて	뜨끔	0	//キュンッて
ヶキュンッーと	뜨-끔	0	//キュンッーと
ヶギョッと	오싹	0	//ギョッと
ヶギョッて	오싹	0	//ギョッて
ヶギョッーと	오-싹	0	//ギョッーと
ヶククッと	쿠쿡	0	//ククッと
ヶククッて	쿠쿡	0	//ククッて
ヶククッーと	쿠-쿡	0	//ククッーと
ヶクククッと	쿠쿠쿡	0	//クククッと
ヶクククッて	쿠쿠쿡	0	//クククッて
ヶクククッーと	쿠쿠-쿡	0	//クククッーと
ヶクラッと	어찔	0
ヶググッと	구긋	0	//ググッと
ヶググッて	구긋	0	//ググッて
ヶググッーと	구-긋	0	//ググッーと
ヶグググッと	구구긋	0	//グググッと
ヶグググッて	구구긋	0	//グググッて
ヶグググッーと	구구-긋	0	//グググッーと
ヶグイと	꾸욱	0	//そして艶やかな頬をグイと押さえつけ無理矢理に口を抉じ開ける
ヶグイーと	꾸-욱	0	//そして艶やかな頬をグイーと押さえつけ無理矢理に口を抉じ開ける
ヶグイッと	꾸욱	0	//グイッと
ヶグイッて	꾸욱	0	//グイッと
ヶグイッーと	꾸-욱	0	//グイッーと
ヶグンッと	쭈욱	0	//グンッと
ヶグンッて	쭈욱	0	//グンッて
ヶグンッーと	쭈-욱	0	//グンッーと
ヶグーンッと	쭈-욱	0	//グーンッと
ヶグーンッて	쭈-욱	0	//グーンッて伸びてるなんて……太くて、硬くて…
ヶグーンッーと	쭈-욱	0	//グーンッーと
ヶコクンと	끄덕	0
ヶコクンッと	끄덕	0
ヶコクンッて	끄덕	0	//コクンッて
ヶコクンッーと	끄-덕	0	//コクンッーと
ヶサッと	휙	0
ヶサッて	휙	0
ヶサーッと	휙-	0
ヶサーッて	휙-	0
ヶササッと	사샥	0
ヶササッて	사샥	0
ヶササッーと	사-샥	0	//ササッーと
ヶサッサと	빨리	0
ヶサラッと	슬쩍	0
ヶサラッて	슬쩍	0
ヶサラッーと	슬-쩍	0	//サラッーと
ヶサクッと	샥[ザクッと]	0
ヶサクッて	샥[ザクッて]	0
ヶサクッーと	샥[ザクッと]	0	//サクッーと
ヶザクッと	스윽[ザクッと]	0
ヶサクッて	샥[ザクッて]	0
ヶザクッーと	스-윽[ザクッ-と]	0	//ザクッーと
ヶシラッと	썰렁	0
ヶシレッと	무심코	0
ヶシャンと	반듯이	0
ヶシャンーと	반듯이	0	//シャンーと
ヶシャンッと	반듯이	0
ヶシャンッて	반듯이	0
ヶシャンッーと	반듯이	0	//シャンッーと
ヶシンと	싸아[シンと]	0
ヶシンーと	싸-아[シン-と]	0	//シンーと
ヶシンッと	싸아[シンッと]	0
ヶシンッて	싸아[シンッて]	0
ヶシンッーと	싸-아[シンッ-と]	0	//シンッーと
ヶジッと	가만히	0
ヶジーッと	가만히	0
ヶジッて	가만히	0
ヶジーッて	가만히	0
ヶジッーと	가만히	0	//ジッーと
ヶジロッと	힐끗	0
ヶジロッーと	힐-끗	0	//ジロッーと
ヶジワッと	서서히	0
ヶジワッて	서서히	0
ヶジワッーと	서서히	0	//ジワッーと
ヶスッと	슥	0
ヶスッて	슥	0
ヶスーッと	슥	0
ヶスッーと	슥-	0	//スッーと
ヶズバッと	확실히	0
ヶズバッて	확실히	0
ヶズバッーと	확실히	0	//ズバッーと
ヶズラーッと	줄줄	0
ヶズラッと	줄줄	0
ヶソッと	살짝	0
ヶソッーと	살-짝	0	//ソッーと
ヶゾッと	섬칫	0
ヶゾッーと	섬-칫	0	//ゾッーと
ヶチンッと	칭	0
ヶツンと	찡	0
ヶツンーと	찡-	0	//ツンーと
ヶツンッと	찡	0
ヶツンッて	찡	0
ヶツンッーと	찡-	0	//ツンッーと
ヶツーンと	찡	0
ヶツーンーと	찡-	0	//ツンーと
ヶツーンッと	찡	0
ヶツーンッて	찡	0
ヶドッと	두둣	0
ヶドッーと	두-둣	0	//ドッーと
ヶドンと	펑	0
ヶドンーと	펑-	0	//ドンーと
ヶドンッと	펑	0
ヶドンッて	펑	0
ヶドンッーと	펑-	0	//ドンッーと
ヶニッと	힐쭉	0
ヶニッーと	힐-쭉	0	//ニッーと
ヶハッと	확	0
ヶハッーと	확-	0	//ハッーと
ヶパッと	팍	0
ヶパッーと	팍-	0	//パッーと
ヶヒクンと	흠칫	0
ヶヒクンーと	흠-칫	0	//ヒクンーと
ヶヒクンッと	흠칫	0
ヶヒクンッて	흠칫	0
ヶヒクンッーと	흠-칫	0	//ヒクンッーと
ヶピクンと	꿈틀	0
ヶピクンーと	꿈-틀	0	//ピクンーと
ヶピクンッと	꿈틀	0
ヶピクンッて	꿈틀	0
ヶピクンッーと	꿈-틀	0	//ピクンッーと
ヶピュンと	퓽	0
ヶピュンッと	퓨웅	0
ヶピュンーと	퓨웅	0
ヶピュンッーと	퓨웅	0
ヶビビッと	찌릿	0
//ヶビビッて	찌릿	0	//びびって로 바뀜
ヶビビッーと	찌-릿	0	//ビビッーと
ヶピンと	핑	0
ヶピンッと	핑	0
ヶピンッて	핑	0
ヶピンッーと	핑-	0	//ピンッーと
ヶピィンと	피잉	0
ヶピィンッと	피잉	0
ヶピィンッて	피잉	0
ヶピィンッーと	피-잉	0	//ピィンッーと
ヶフッと	문득	0
ヶフッーと	문-득	0	//フッーと
ヶフフッと	후훗	0
ヶフフッて	후훗	0
ヶフフッーと	후훗-	0	//フフッーと
ヶフフフッと	후후훗	0
ヶフフフッて	후후훗	0
ヶフフフッーと	후후-훗	0	//フフフッーと
ヶフラッと	훌쩍	0
ヶフラッて	훌쩍	0
ヶフラッーと	훌-쩍	0	//フラッーと
ヶペタンと	풀썩	0
ヶペタンーと	풀-썩	0
ヶペタンッと	풀썩	0
ヶペタンッて	풀썩	0
ヶペタンッーと	풀-썩	0	//ペタンッーと
ヶホワッと	둥실	0
ヶホワッて	둥실	0
ヶホワッーと	둥실	0	//ホワッーと
ヶボッと	멍하니	0
ヶボッーと	멍-하니	0	//ボッーと
ヶボーと	멍-하니	0
ヶボーッと	멍-하니	0
ヶボォッと	멍하니	0
ヶボォッーと	멍-하니	0	//ボォッーと
ヶボサッと	멍하니	0
ヶボサッて	멍하니	0
ヶボサッーと	멍-하니	0	//ボサッーと
ヶボソッと	살그머니	0
ヶボソッて	살그머니	0
ヶボソッーと	살그머-니	0	//ボソッーと
ヶポッと	화끈	0
ヶポッーと	화-끈	0	//ポッーと
ヶポォッと	화끈	0
ヶポォッて	화끈	0
ヶポォッーと	화-끈	0	//ポォッーと
ヶムスッと	시무룩	0
ヶワザと	일부러	0
ヶワリと	생각보다	0
ヶきゅうと	꽈악	0
ヶじわぁっと	서-서히	0	//庭の暖気が押し流されて、じわと冷気が身に沁みる。
ヶじわっと	서서히	0	//庭の暖気が押し流されて、じわと冷気が身に沁みる。
ヶじわと	서서히	0	//庭の暖気が押し流されて、じわと冷気が身に沁みる。
ヶわっと	왓하고	0	//すると、わっと転校生の周りに輪ができる。
ヶぺろんと	날름	0	//自分の残り香を刻むようにぺろんと舐められ、正気を取り戻した俺は慌てて後ずさった。
ヶぺろんっと	날름	0
ヶじーんと	찌잉	0
ヶじーんっと	찌잉	0
ヶじーんて	찌잉	0
ヶじーんって	찌잉	0
ヶおおっと	어이쿠	0
ヶぷいと	홱	0	//ユエラはぷいと横を向いてしまう。
ヶぷいーと	홱	0	//ユエラはぷいと横を向いてしまう。
ヶぽいと	홱	0
ヶぽいーと	홱	0
ヶばたんと	덜컹	0
ヶしんと	고요히	0
ヶしーんと	고요-히	0
ヶつんと	쨍	0
ヶつーんと	쨍-	0
ヶちらと	흘깃	0
ヶワフッと	와훗	0
ヶザラッと	까끌	0

//
ヶカクリ	털썩∥r	0
ヶカクリッ	털썩∥r	0
ヶカックリ	털썩∥r	0
ヶカックリッ	털썩∥r	0
ヶガラリ	드르륵∥r	0
ヶガラリッ	드르륵∥r	0
ヶガブリ	덥썩∥r	0
ヶガブリッ	덥썩∥r	0
ヶキラリ	반짝∥r	0
ヶキラリッ	반짝∥r	0
ヶギクリ	움찔∥r	0
ヶギクリッ	움찔∥r	0
ヶギラリ	번쩍∥r	0
ヶギラリッ	번쩍∥r	0
ヶギロリ	번득∥r	0
ヶギロリッ	번득∥r	0
ヶグサリ	푸욱∥r	0
ヶグサリッ	푸욱∥r	0
ヶコクリ	끄덕∥r	0
ヶコクリッ	끄덕∥r	0
ヶゴクリ	꿀꺽∥r	0
ヶゴクリッ	꿀꺽∥r	0
ヶゴロリ	데구르르∥r	0
ヶゴロリッ	데구르르∥r	0
ヶジロリ	흘깃∥r	0
ヶジロリッ	흘깃∥r	0
ヶスルリ	스르륵∥r	0
ヶスルリッ	스르륵∥r	0
ヶズキリ	욱신∥r	0
ヶズキリッ	욱신∥r	0
ヶズシリ	묵직∥r	0
ヶズシリッ	묵직∥r	0
ヶズブリ	푸욱∥r	0
ヶズブリッ	푸욱∥r	0
ヶズラリ	주욱∥r	0
ヶズラリッ	주욱∥r	0
ヶズルリ	주르륵∥r	0
ヶズルリッ	주르륵∥r	0
ヶゾクリ	흠칫∥r	0
ヶゾクリッ	흠칫∥r	0
ヶゾワリ	섬칫∥r	0
ヶゾワリッ	섬칫∥r	0
ヶチクリ	따끔∥r	0
ヶチクリッ	따끔∥r	0
ヶチラリ	슬쩍∥r	0
ヶチラリッ	슬쩍∥r	0
ヶドサリ	털썩∥r	0
ヶドサリッ	털썩∥r	0
ヶニコリ	생긋∥r	0
ヶニコリッ	생긋∥r	0
ヶニヤリ	힐쭉∥r	0
ヶニヤリッ	힐쭉∥r	0
ヶネットリ	끈적∥r	0
ヶネットリッ	끈적∥r	0
ヶバサリ	바스락∥r	0
ヶバサリッ	바스락∥r	0
ヶバッタリ	털썩∥r	0
ヶバッタリッ	털썩∥r	0
ヶヒラリ	훌쩍∥r	0
ヶヒラリッ	훌쩍∥r	0
ヶピッチリ	꼭∥r	0
ヶピッチリッ	꼭∥r	0
ヶブツリ	툭∥r	0
ヶブツリッ	툭∥r	0
ヶペコリ	꾸벅∥r	0
ヶペコリッ	꾸벅∥r	0
ヶベロリ	할짝∥r	0
ヶベロリッ	할짝∥r	0
ヶペロリ	낼름∥r	0
ヶペロリッ	낼름∥r	0
ヶポキリ	똑∥r	0
ヶポキリッ	똑∥r	0
ヶポタリ	똑∥r	0
ヶポタリッ	똑∥r	0
ヶポロリ	툭∥r	0
ヶポロリッ	툭∥r	0
ヶムッツリ	무뚝뚝∥r	0
ヶムッツリッ	무뚝뚝∥r	0
ヶモッコリ	볼록∥r	0
ヶモッコリッ	볼록∥r	0



//단순의성어
いらっヶ戰	울컥	0
うるっヶ戰	울컥	0
イラッヶ戰	울컥∥d	0
ウルッヶ戰	울컥∥d	0
おっほんヶ戰	어흠	0
おっほんっヶ戰	어흠	0
//か
かくっヶ戰	털썩	0
かくんっヶ戰	털썩	0
かくんヶ戰	털썩	0
カクッヶ戰	털썩∥d	0
カクンッヶ戰	털썩∥d	0
かさっヶ戰	부스럭	0
カサッヶ戰	부스럭∥d	0
かしゃぁっヶ戰	찰칵	0
かしゃっヶ戰	찰칵	0
かしゃっヶ戰	찰칵	0
かしゃヶ戰	찰칵	0
カシャァッヶ戰	찰칵∥d	0
カシャァヶ戰	찰칵∥d	0
カシャッヶ戰	찰칵∥d	0
カシャヶ戰	찰칵∥d	0
かしゃーんっヶ戰	챙그랑	0
かしゃーんヶ戰	챙그랑	0
かしゃんっヶ戰	챙그랑	0
かしゃんヶ戰	챙그랑	0
カシャーンッヶ戰	챙그랑∥d	0
カシャーンヶ戰	챙그랑∥d	0
カシャンッヶ戰	챙그랑∥d	0
カシャンヶ戰	챙그랑∥d	0
かたーんっヶ戰	콰당	0
かたーんヶ戰	콰당	0
かたんっヶ戰	콰당	0
かたんヶ戰	콰당	0
カターンッヶ戰	콰당∥d	0
カターンヶ戰	콰당∥d	0
カタンッヶ戰	콰당∥d	0
カタンヶ戰	콰당∥d	0
かちりっヶ戰	철컥	0
かちりヶ戰	철컥	0
かちっヶ戰	철컥	0
カチリッヶ戰	철컥∥d	0
カチリヶ戰	철컥∥d	0
カチッヶ戰	철컥∥d	0
かちゃぁっヶ戰	찰칵	0
かちゃっヶ戰	찰칵	0
かちゃっヶ戰	찰칵	0
かちゃヶ戰	찰칵	0
カチャァッヶ戰	찰칵∥d	0
カチャァヶ戰	찰칵∥d	0
カチャッヶ戰	찰칵∥d	0
カチャヶ戰	찰칵∥d	0
かちゃーんっヶ戰	챙그랑	0
かちゃーんヶ戰	챙그랑	0
かちゃんっヶ戰	챙그랑	0
かちゃんヶ戰	챙그랑	0
カチャーンッヶ戰	챙그랑∥d	0
カチャーンヶ戰	챙그랑∥d	0
カチャンッヶ戰	챙그랑∥d	0
カチャンヶ戰	챙그랑∥d	0
カチンッヶ戰	짤그랑∥d	0
かつーんっヶ戰	째-앵	0
かつーんヶ戰	째-앵	0
かつんっヶ戰	째앵	0
かつんヶ戰	째앵	0
カツーンッヶ戰	째앵∥d	0
カツーンヶ戰	째-앵∥d	0
カツンッヶ戰	째앵∥d	0
カツンヶ戰	째앵∥d	0
かりっヶ戰	바삭	0
カリッヶ戰	바삭∥d	0
//が
がくっヶ戰	털썩	0
がくんっヶ戰	털썩	0
がくんヶ戰	털썩	0
ガクッヶ戰	털썩∥d	0
ガクンッヶ戰	털썩∥d	0
がさっヶ戰	부스럭	0
ガサッヶ戰	부스럭∥d	0
がしっヶ戰	파앗	0
ガシッヶ戰	파앗∥d	0
がしゃーんっヶ戰	챙-그랑	0
がしゃーんヶ戰	챙-그랑	0
がしゃんっヶ戰	챙그랑	0
がしゃんヶ戰	챙그랑	0
ガシャーンッヶ戰	챙-그랑∥d	0
ガシャーンヶ戰	챙-그랑∥d	0
ガシャンッヶ戰	챙그랑∥d	0
ガシャンヶ戰	챙그랑∥d	0
がたーんっヶ戰	덜-컹	0
がたーんヶ戰	덜-컹	0
がたんっヶ戰	덜컹	0
がたんヶ戰	덜컹	0
ガターンッヶ戰	덜-컹∥d	0
ガターンヶ戰	덜-컹∥d	0
ガタンッヶ戰	덜컹∥d	0
ガタンヶ戰	덜컹∥d	0
がちゃぁっヶ戰	절컥	0
がちゃぁヶ戰	절컥	0
がちゃっヶ戰	절컥	0
がちゃヶ戰	절컥	0
ガチャァッヶ戰	절컥∥d	0
ガチャッヶ戰	절컥∥d	0
がちゃーんっヶ戰	챙-그랑	0
がちゃーんヶ戰	챙-그랑	0
がちゃんっヶ戰	챙그랑	0
がちゃんヶ戰	챙그랑	0
ガチャーンッヶ戰	챙그랑∥d	0
ガチャーンヶ戰	챙그랑∥d	0
ガチャンッヶ戰	챙그랑∥d	0
ガチャンヶ戰	챙그랑∥d	0
がちーんっヶ戰	짤-각	0
がちーんヶ戰	짤-각	0
がちんっヶ戰	짤각	0
がちんヶ戰	짤각	0
ガチーンッヶ戰	짤-각∥d	0
ガチーンヶ戰	짤-각∥d	0
ガチンッヶ戰	짤각∥d	0
ガチンヶ戰	짤각∥d	0
がつーんっヶ戰	퍼-억	0
がつーんヶ戰	퍼-억	0
がつんっヶ戰	퍼억	0
がつんヶ戰	퍼억	0
ガツーンッヶ戰	퍼-억∥d	0
ガツーンヶ戰	퍼-억∥d	0
ガツンッヶ戰	퍼억∥d	0
ガツンヶ戰と	똑 부러지게∥d	0
ガツンヶ戰	퍼억∥d	0
ガッヶ戰	콱∥d	0
がばぁっヶ戰	화악	0
がばっヶ戰	화악	0
ガバァッヶ戰	화악∥d	0
ガバッヶ戰	화악∥d	0
がぼっヶ戰	커헉	0
がーんっヶ戰	쾅	0
がーんヶ戰	쾅	0
ガーンッヶ戰	쾅∥d	0
ガーンヶ戰	쾅∥d	0
//き
きちっヶ戰	꽉	0
キチッヶ戰	꽉∥d	0
きらっヶ戰	반짝	0
キラッヶ戰	반짝∥d	0
きりりりっヶ戰	키리리릭	0
きりりっヶ戰	키리릭	0
きゅきゅっヶ戰	꾸꾹	0
キュキュッヶ戰	꾸꾹∥d	0
//ギ
ギクッヶ戰	흠칫∥d	0
ぎしっヶ戰	삐걱	0
ぎしヶ戰	삐걱	0
ギシッヶ戰	삐걱∥d	0
ぎりっヶ戰	으득	0
ギリッヶ戰	으득∥d	0
ぎゅっヶ戰	꾹	0
ギュッヶ戰	꾹∥d	0
ぎゅうっヶ戰	꾸욱	0
ぎゅぅっヶ戰	꾸욱	0
ギュウッヶ戰	꾸욱∥d	0
ギュゥッヶ戰	꾸욱∥d	0
ぎゅむうっヶ戰	꽈악	0
ぎゅむぅっヶ戰	꽈악	0
ぎゅむっヶ戰	꽈악	0
ギュムウッヶ戰	꽈악∥d	0
ギュムゥッヶ戰	꽈악∥d	0
ギュムッヶ戰	꽈악∥d	0
//く
くしゅんっヶ戰	엣취	0
くしゅんヶ戰	엣취	0
くしゅっヶ戰	엣취	0
くしゅヶ戰	엣취	0
くしょんっヶ戰	엣취	0
くしょんヶ戰	엣취	0
くしょっヶ戰	엣취	0
クシュンッヶ戰	엣취∥d	0
クシュンヶ戰	엣취∥d	0
クシュッヶ戰	엣취∥d	0
クシュヶ戰	엣취∥d	0
クションッヶ戰	엣취∥d	0
クションヶ戰	엣취∥d	0
クショッヶ戰	엣취∥d	0
くすっヶ戰	키득	0
クスッヶ戰	키득∥d	0
くすすすっヶ戰	쿡쿡쿡	0
くすすすヶ戰	쿡쿡쿡	0
くすすっヶ戰	쿡쿡	0
くすすヶ戰	쿡쿡	0
くすんっヶ戰	훌쩍	0
くすんヶ戰	훌쩍	0
クスンッヶ戰	훌쩍∥d	0
クスンヶ戰	훌쩍∥d	0
くちゃっヶ戰	질척	0
クチャッヶ戰	질척∥d	0
くちゅっヶ戰	쿠츗	0
クチュッヶ戰	쿠츗∥d	0
くちゅんっヶ戰	엣취	0
くちゅんヶ戰	엣취	0
くちゅヶ戰	엣취	0
くちょんっヶ戰	엣취	0
くちょんヶ戰	엣취	0
くちょっヶ戰	엣취	0
クチュンッヶ戰	엣취∥d	0
クチュンヶ戰	엣취∥d	0
クチュヶ戰	엣취∥d	0
クチョンッヶ戰	엣취∥d	0
クチョンヶ戰	엣취∥d	0
クチョッヶ戰	엣취∥d	0
クッヶ戰	큭∥d	0	//クッーと
くねっヶ戰	구불	0
クネッヶ戰	구불∥d	0
//ぐ
ぐさっヶ戰	푸욱	0
グサッヶ戰	푸욱∥d	0
ぐじゅっヶ戰	질척	0
グジュッヶ戰	질척∥d	0
ぐすっヶ戰	흐흑	0
ぐずっヶ戰	흐흑	0
グスッヶ戰	흐흑∥d	0
グズッヶ戰	흐흑∥d	0
ぐすんっヶ戰	훌쩍	0
ぐすんヶ戰	훌쩍	0
グスンッヶ戰	훌쩍∥d	0
グスンヶ戰	훌쩍∥d	0
ぐちゅっヶ戰	질척	0
ぐちゅヶ戰	구츄	0
グチュッヶ戰	질척∥d	0
グチュヶ戰	구츄∥d	0
ぐちゅりっヶ戰	질척	0
ぐちゅりヶ戰	질척	0
グチュリッヶ戰	질척∥d	0
グチュリヶ戰	질척∥d	0
ぐぢゅっヶ戰	질척	0
グヂュッヶ戰	질척∥d	0
ぐっちゅりっヶ戰	질척	0
ぐっちゅりヶ戰	질척	0
グッチュリッヶ戰	질척∥d	0
グッチュリヶ戰	질척∥d	0
ぐりっヶ戰	꾸욱	0
グリッヶ戰	꾸욱∥d	0
ぐりゅっヶ戰	퍼억	0
グリュッヶ戰	퍼억∥d	0
けふっヶ戰	콜록	0
ケフッヶ戰	콜록∥d	0
けほっヶ戰	콜록	0
けほヶ戰	콜록	0
ケホッヶ戰	콜록∥d	0
ケホヶ戰	콜록∥d	0
げしっヶ戰	퍽	0
ゲシッヶ戰	퍽∥d	0
げふっヶ戰	쿨럭	0
げふヶ戰	쿨럭	0
ゲフッヶ戰	쿨럭∥d	0
ゲフヶ戰	쿨럭∥d	0
げふんっヶ戰	쿨럭	0
げふんヶ戰	쿨럭	0
ゲフンッヶ戰	쿨럭∥d	0
ゲフンヶ戰	쿨럭∥d	0
げほっヶ戰	쿨럭	0
げほヶ戰	쿨럭	0
ゲホッヶ戰	쿨럭∥d	0
ゲホヶ戰	쿨럭∥d	0
げほんっヶ戰	쿨럭	0
げほんヶ戰	쿨럭	0
ゲホンッヶ戰	쿨럭∥d	0
ゲホンヶ戰	쿨럭∥d	0
//こ
こくっヶ戰	끄덕	0
コクッヶ戰	끄덕∥d	0
こつんっヶ戰	딱	0
こつんヶ戰	딱	0
コツンッヶ戰	딱∥d	0
コツンヶ戰	딱∥d	0
こほっヶ戰	콜록	0
こほヶ戰	콜록	0
こほんっヶ戰	어흠	0
こほんヶ戰	어흠	0
コホッヶ戰	콜록∥d	0
コホヶ戰	콜록∥d	0
コホンッヶ戰	어흠∥d	0
コホンヶ戰	어흠∥d	0
こりっヶ戰	으득	0
コリッヶ戰	으득∥d	0
ころっヶ戰	홀랑	0
コロッヶ戰	홀랑∥d	0
ころんヶ戰	데굴	0
ころんっヶ戰	데굴	0
コロンッヶ戰	데굴∥d	0
コンッヶ戰	콩∥d	0
コンヶ戰	콩∥d	0
//ご
ごきゅっヶ戰	꿀꺽	0
ゴキュッヶ戰	꿀꺽∥d	0
ごつんっヶ戰	쿵	0
ごつんヶ戰	쿵	0
ゴツンッヶ戰	쿵∥d	0
ゴツンヶ戰	쿵∥d	0
ごにょヶ戰	소곤	0
ゴニョヶ戰	소곤∥d	0
ごほっヶ戰	쿨럭	0
ごほヶ戰	쿨럭	0
ごほんっヶ戰	어흠	0
ごほんヶ戰	어흠	0
ゴホッヶ戰	쿨럭∥d	0
ゴホヶ戰	쿨럭∥d	0
ゴホンッヶ戰	어흠∥d	0
ゴホンヶ戰	어흠∥d	0
ごぼぼっヶ戰	쿨럭	0
ごぼぼヶ戰	쿨럭	0
ごぼっヶ戰	쿨럭	0
ごぼヶ戰	쿨럭	0
ごりっヶ戰	으득	0
ゴリッヶ戰	으득∥d	0
ごりゅっヶ戰	퍼억	0
ゴリュッヶ戰	퍼억∥d	0
ごろんっヶ戰	뒹굴	0
ごろんヶ戰	뒹굴	0
ゴロンッヶ戰	뒹굴∥d	0
//さ
サクッヶ戰	아삭∥d	0
サーヶ戰	솨-∥d	0
サーサーヶ戰	솨-솨-∥d	0
ザーザーヶ戰	좌-좌-∥d	0
ざざっヶ戰	사삭	0
ざっぱんっヶ戰	첨벙	0
ざっぱんヶ戰	첨벙	0
ザッパンッヶ戰	첨벙	0
ザッパンヶ戰	첨벙	0
ざぱんっヶ戰	첨벙	0
ザパンッヶ戰	첨벙	0
ざわっヶ戰	술렁	0
ザワッヶ戰	술렁∥d	0
ざわヶ戰	술렁	0
ザワヶ戰	술렁∥d	0
//し
しっヶ戰	쉿	0
シッヶ戰	쉿∥d	0
しゃっヶ戰	샷	0
シャッヶ戰	샷∥d	0
じゃじゃんっヶ戰	짜잔	0
じゃじゃんヶ戰	짜잔	0
じゃじゃじゃんっヶ戰	짜자잔	0
じゃじゃじゃんヶ戰	짜자잔	0
じゃじゃじゃじゃんっヶ戰	짜자자잔	0
じゃじゃじゃじゃんヶ戰	짜자자잔	0
じゃんっヶ戰	짠	0
じゃんヶ戰	짠	0
じゃりっヶ戰	자그락	0
ジャリッヶ戰	자그락∥d	0
じゅわっヶ戰	쥬왓	0
じょきっヶ戰	사각	0
じょきヶ戰	사각	0
//す
すーぅヶ戰	스으	0
すぅヶ戰	스으	0
すかっヶ戰	화악	0
スカッヶ戰	화악∥d	0
すーぴヶ戰	쿨-	0
すぴヶ戰	쿨	0
すぽっヶ戰	쏘옥	0
スポッヶ戰	쏘옥∥d	0
ずいっヶ戰	즈윽	0
ズイッヶ戰	즈윽∥d	0
ずちゃっヶ戰	질척	0
ズチャッヶ戰	질척∥d	0
ズドーンッヶ戰	쾅∥d	0
ズドンッヶ戰	쾅∥d	0
ずるっヶ戰	주륵	0
ずるんっヶ戰	스륵	0
ズルッヶ戰	주륵∥d	0
ズルンッヶ戰	스륵∥d	0
ズンッヶ戰	즈읏∥d	0
//ぞ
ぞくんっヶ戰	오싹	0
ぞくんヶ戰	오싹	0
ぞくっヶ戰	오싹∥d	0
ゾクンッヶ戰	오싹∥d	0
ゾクンヶ戰	오싹∥d	0
ゾクッヶ戰	오싹∥d	0
ぞわっヶ戰	오싹	0
ゾワッヶ戰	오싹∥d	0
//ち
ちくっヶ戰	따끔	0
チクッヶ戰	따끔∥d	0
ちらっヶ戰	슬쩍	0
ちゃっぷっヶ戰	첨벙	0
ちゃっぷヶ戰	첨벙	0
ちゃぷっヶ戰	첨벙	0
ちゃぷヶ戰	첨벙	0
チャップッヶ戰	첨벙∥d	0
チャップヶ戰	첨벙∥d	0
チャプッヶ戰	첨벙∥d	0
チャプヶ戰	첨벙∥d	0
チュッヶ戰	츗∥d	0
ちょこんっヶ戰	톡	0
ちょこんヶ戰	톡	0
チョコンッヶ戰	톡∥d	0
チョコンヶ戰	톡∥d	0
ちょろっヶ戰	살짝	0
チョロッヶ戰	살짝∥d	0
//つ
つんヶ戰	츤	0
ツルンッヶ戰	주륵∥d	0
ツルンヶ戰	주륵∥d	0
っくしゅんっヶ戰	으엣취	0
っくしゅんヶ戰	으엣취	0
っくしゅっヶ戰	으엣취	0
っくしゅヶ戰	으엣취	0
っくしょんっヶ戰	으엣취	0
っくしょんヶ戰	으엣취	0
っくしょっヶ戰	으엣취	0
ックシュンッヶ戰	으엣취∥d	0
ックシュンヶ戰	으엣취∥d	0
ックシュッヶ戰	으엣취∥d	0
ックシュヶ戰	으엣취∥d	0
ックションッヶ戰	으엣취∥d	0
ックションヶ戰	으엣취∥d	0
ックショッヶ戰	으엣취∥d	0
っくちゅんっヶ戰	으엣취	0
っくちゅんヶ戰	으엣취	0
っくちゅっヶ戰	으엣취	0
っくちゅヶ戰	으엣취	0
っくちょんっヶ戰	으엣취	0
っくちょんヶ戰	으엣취	0
っくちょっヶ戰	으엣취	0
ックチュンッヶ戰	으엣취∥d	0
ックチュンヶ戰	으엣취∥d	0
ックチュッヶ戰	으엣취∥d	0
ックチュヶ戰	으엣취∥d	0
ックチョンッヶ戰	으엣취∥d	0
ックチョンヶ戰	으엣취∥d	0
ックチョッヶ戰	으엣취∥d	0
トンッヶ戰	통∥d	0
どかーんヶ戰	쾅	0
どかーんっヶ戰	쾅	0
どくっヶ戰	출렁	0
ドクッヶ戰	출렁∥d	0
ドサッヶ戰	드삭∥d	0
ドスッヶ戰	드슥∥d	0
どすんっヶ戰	쿵	0
どすんヶ戰	쿵	0
ドスーンッヶ戰	쿵∥d	0
ドスンッヶ戰	쿵∥d	0
ドスーンヶ戰	쿵∥d	0
ドスンヶ戰	쿵∥d	0
どどっヶ戰	두듯	0
ドドッヶ戰	두듯∥d	0
どぼーんっヶ戰	풍-덩	0
どぼーんヶ戰	풍-덩	0
どろっヶ戰	주륵	0
ドロッヶ戰	주륵∥d	0
どんっヶ戰	둥	0
ドンッヶ戰	둥∥d	0
//に
にこっヶ戰	싱긋	0
にこヶ戰	싱긋	0
ニコッヶ戰	싱긋∥d	0
にやりっヶ戰	힐쯕	0
にやりヶ戰	힐쯕	0
ぬちゃっヶ戰	질척	0
ぬちゅっヶ戰	질척	0
ヌチャッヶ戰	질척∥d	0
ヌチュッヶ戰	질척∥d	0
ぬめっヶ戰	미끌	0
ヌメッヶ戰	미끌∥d	0
ぬるんっヶ戰	미끌	0
ぬるっヶ戰	미끌	0
ヌルンッヶ戰	미끌∥d	0
ヌルッヶ戰	미끌∥d	0
ねちゃっヶ戰	꿀쩍	0
ねちゃヶ戰	꿀쩍	0
ネチャッヶ戰	꿀쩍∥d	0
ネチャヶ戰	꿀쩍∥d	0
ねろんっヶ戰	할짝	0
ねろんヶ戰	할짝	0
//は
はぐっヶ戰	하긋	0
はむっヶ戰	하믓	0
ハグッヶ戰	하긋∥d	0
ハムッヶ戰	하믓∥d	0
バサッヶ戰	휙∥d	0
ばしっヶ戰	철썩	0
バシッヶ戰	철썩∥d	0
ばたーんっヶ戰	덜-컹	0
ばたーんヶ戰	덜-컹	0
ばたんっヶ戰	덜컹	0
ばたんヶ戰	덜컹	0
バターンッヶ戰	덜-컹∥d	0
バターンヶ戰	덜-컹∥d	0
バタンッヶ戰	덜컹∥d	0
バタンヶ戰	덜컹∥d	0
ばだーんっヶ戰	덜-컹	0
ばだーんヶ戰	덜-컹	0
ばだんっヶ戰	덜컹	0
ばだんヶ戰	덜컹	0
バダーンッヶ戰	덜-컹∥d	0
バダーンヶ戰	덜-컹∥d	0
バダンッヶ戰	덜컹∥d	0
バダンヶ戰	덜컹∥d	0
ばちんっヶ戰	철썩	0
ばちんヶ戰	철썩	0
バチンッヶ戰	철썩∥d	0
バチンヶ戰	철썩∥d	0
ばふっヶ戰	바훅	0
パカッヶ戰	확∥d	0
ぱくっヶ戰	뻐끔	0
ぱくヶ戰	뻐끔	0
ぱたーんっヶ戰	덜-컹	0
ぱたーんヶ戰	덜-컹	0
ぱたんっヶ戰	덜컹	0
ぱたんヶ戰	덜컹	0
ぱだーんっヶ戰	덜-컹	0
ぱだーんヶ戰	덜-컹	0
ぱだんっヶ戰	덜컹	0
ぱだんヶ戰	덜컹	0
ぱちんっヶ戰	짜악	0
ぱちんヶ戰	짜악	0
パチンッヶ戰	짜악∥d	0
パチンヶ戰	짜악∥d	0
//ひ
ひくんっヶ戰	흠칫	0
ひくんヶ戰	흠칫	0
ヒクンッヶ戰	흠칫∥d	0
ヒクンヶ戰	흠칫∥d	0
ひっくヶ戰	훌쩍	0
びくっヶ戰	흠칫	0
ビクッヶ戰	흠칫∥d	0
びくんっヶ戰	흠칫	0
びくんヶ戰	흠칫	0
ビクンッヶ戰	흠칫∥d	0
ビクンヶ戰	흠칫∥d	0
びゅくんっヶ戰	뷰쿵	0
びゅくんヶ戰	뷰쿵	0
ビュクンッヶ戰	뷰쿵∥d	0
ビュクンヶ戰	뷰쿵∥d	0
ビュッヶ戰	븃∥d	0
ぴくっヶ戰	흠칫	0
ピクッヶ戰	흠칫∥d	0
ぴたっヶ戰	찰싹	0
ぴたヶ戰	찰싹	0
ピタッヶ戰	찰싹∥d	0
ぴちゃっヶ戰	피챳	0
ピチャッヶ戰	피챳∥d	0
ピンッヶ戰	핑∥d	0
ふぅむヶ戰	흐음	0
ふーむヶ戰	흠	0
ふむヶ戰	흠	0
ふーんヶ戰	흐음	0
フニャンヶ戰	후냥∥d	0
フニャンッヶ戰	후냥∥d	0
ふらっヶ戰	흔들	0
フラッヶ戰	흔들∥d	0
フワッヶ戰	둥실∥d	0
フンヶ戰	흥∥d	0
フンッヶ戰	흥∥d	0
//ブ
ブシュッヶ戰	부슛∥d	0
ぶっぶヶ戰	부뿌	0
プッツンッヶ戰	툭∥d	0
プッツンヶ戰	툭∥d	0
ぶるっヶ戰	부들	0
ブルッヶ戰	부들∥d	0
ぶるるっヶ戰	부르르	0
ぶるるヶ戰	부르르	0
ブルルッヶ戰	부르르∥d	0
ブルルヶ戰	부르르∥d	0
ぶるんっヶ戰	부릉	0
ぶるんヶ戰	부릉	0
ブルンッヶ戰	부릉∥d	0
ブルンヶ戰	부릉∥d	0
ぷいっヶ戰	푸잇	0
プイッヶ戰	푸잇∥d	0
プシュッヶ戰	푸슛∥d	0
ぷりんっヶ戰	탱글	0
プリンッヶ戰	탱글∥d	0
ぷりっヶ戰	탱글	0
プリッヶ戰	탱글∥d	0
ぷるるんっヶ戰	출렁	0
ぷるんっヶ戰	출렁	0
ぷるるっヶ戰	출렁	0
ぷるっヶ戰	출렁	0
プルルンッヶ戰	출렁∥d	0
プルンッヶ戰	출렁∥d	0
プルルッヶ戰	출렁∥d	0
プルッヶ戰	출렁∥d	0
べろんっヶ戰	날름	0
べろんヶ戰	날름	0
べろっヶ戰	날름	0
べろヶ戰	날름	0
ベロッヶ戰	날름∥d	0
ベロンッヶ戰	날름∥d	0
ぺこっヶ戰	꾸벅	0
ぺしっヶ戰	찰싹	0
ぺちゃっヶ戰	페챳	0
ペチャッヶ戰	페챳∥d	0
ぺろんっヶ戰	할짝	0
ぺろんヶ戰	할짝	0
ぺろっヶ戰	할짝	0
ぺろヶ戰	할짝	0
ペロッヶ戰	할짝∥d	0
ペロンッヶ戰	할짝∥d	0
ぽいっヶ戰	쏘옥	0
ポイッヶ戰	쏘옥∥d	0
ポンッヶ戰	퐁∥d	0
//み
みしっヶ戰	삐걱	0
むかっヶ戰	울컥	0
ムカッヶ戰	울컥∥d	0
ムキュッヶ戰	무큣∥d	0
むぎゅっヶ戰	꼬옥	0
むぎゅヶ戰	꼬옥	0
ムギュッヶ戰	꼬옥∥d	0
ムギュヶ戰	꼬옥∥d	0
むぎゅうっヶ戰	꽈악	0
むぎゅうヶ戰	꽈악	0
むぎゅぅっヶ戰	꽈악	0
むぎゅぅヶ戰	꽈악	0
ムギュウッヶ戰	꽈악∥d	0
ムギュウヶ戰	꽈악∥d	0
ムギュゥッヶ戰	꽈악∥d	0
ムギュゥヶ戰	꽈악∥d	0
むくっヶ戰	벌떡	0
ムクッヶ戰	벌떡∥d	0
むちっヶ戰	포동	0
ムチッヶ戰	포동∥d	0
ムチュッヶ戰	무츗∥d	0
むにっヶ戰	쫄깃	0
むにゅうっヶ戰	물컹	0
むにゅぅっヶ戰	물컹	0
むにゅっヶ戰	물컹	0
ムニュウッヶ戰	물컹∥d	0
ムニュゥッヶ戰	물컹∥d	0
ムニュッヶ戰	물컹∥d	0
ムニッヶ戰	쫄깃∥d	0
むらっヶ戰	므흣	0
ムラッヶ戰	므흣∥d	0
ムワッヶ戰	므왓∥d	0
ムンッヶ戰	므읏∥d	0
もぐヶ戰	우물	0
もじっヶ戰	비틀	0
モジッヶ戰	비틀∥d	0
もみっヶ戰	조물락	0
もわんっヶ戰	뭉글	0
モワンッヶ戰	뭉글∥d	0

//+.
フ梦ー梦ケ	フケ	0	//フケる
伊達	겉Date_멋	1
ダヶッテ梦名	왜냐하면[だって]	0
//ダヶッテ梦名	だって─	0
ミツヶドォルジテン	꿀도르 dict	1
