隔絶戰戰	≪동떨어ㅈㅣㄴ∬&≫	0
歯ぎしりを戰戰	≪이를 ㄱㅏㄹ∬&≫	0
足音が戰戰	≪발소리가 ㄴㅏㄴ∬&≫	0
どろんと戰戰	≪흐리멍텅ㅎㅏㄴ∬&≫	0
身震い戰戰	≪몸서리 ㅊㅣㄴ∬&≫	0
むちっと戰戰	≪포동ㅎㅏㄴ∬&≫	0	//むちっとしたママの尻は
ぼんやり戰戰	≪희미ㅎㅏㄴ∬&≫	0
ぼんやりと戰戰	≪어렴풋ㅎㅏㄴ∬&≫	0
付随戰戰	≪뒤따ㄹㅡㄴ∬&≫	0
念押し戰戰	≪거듭 다짐ㅎㅏㄴ∬&≫	0
見劣りが戰戰	≪모자ㄹㅏㄴ∬&≫	0
見劣り戰戰	≪모자ㄹㅏㄴ∬&≫	0
陥落戰戰	≪함락ㄷㅚㄴ∬&≫	0
木霊戰戰	≪메아리ㅊㅣㄴ∬&≫	0
愚弄戰戰	≪우롱ㅎㅏㄴ∬&≫	0
絶頂戰戰	≪절정ㅎㅏㄴ∬&≫	0
瞠目戰戰	≪눈을 둥그렇게 ㄸㅡㄴ∬&≫	0
借り戰戰	≪빌ㄹㅣㄴ∬&≫	0
考え事を戰戰	≪생각을 ㅎㅏㄴ∬&≫	0
仁王立ち戰戰	≪우뚝 서있ㄴㅡㄴ∬&≫	0	//工藤先生が校門脇で仁王立ちしていた。
洗練戰戰	≪세련ㄷㅚㄴ∬&≫	0
再燃戰戰	≪다시 불타오ㄹㅡㄴ∬&≫	0
瞑目戰戰	≪눈을 감ㄴㅡㄴ∬&≫	0
絶句戰戰	≪말문이 막ㅎㅣㄴ∬&≫	0
羽休め戰戰	≪날개를 쉬게 ㅎㅏㄴ∬&≫	0
すっきり戰戰	≪후련ㅎㅏㄴ∬&≫	0
さびしい思いを戰戰	≪쓸쓸ㅎㅏㄴ∬&≫	0
選り好み戰戰	≪편식ㅎㅏㄴ∬&≫	0
夜なべ戰戰	≪밤을 새ㅇㅜㄴ∬&≫	0
送り迎え戰戰	≪바래다 ㅈㅜㄴ∬&≫	0
介護戰戰	≪간호ㅎㅏㄴ∬&≫	0
閉口戰戰	≪할 말을 잃ㄴㅡㄴ∬&≫	0
ダラダラ戰戰	≪게으름 피ㅇㅜㄴ∬&≫	0
おねしょ戰戰	≪지도를 그ㄹㅣㄴ∬&≫	0
一眠り戰戰	≪한 잠 ㅈㅏㄴ∬&≫	0
ぶっち戰戰	≪무시ㅎㅏㄴ∬&≫	0
気が動転戰戰	≪몹시 당황ㅎㅏㄴ∬&≫	0
蓋を戰戰	≪덮ㄴㅡㄴ∬&≫	0
殴り書き戰戰	≪갈겨 ㅆㅡㄴ∬&≫	0	//殴り書きする
屹立戰戰	≪우뚝 솟ㄴㅡㄴ∬&≫	0
然と戰戰	≪같ㅇㅡㄴ∬&≫	0	//スヴェの方が田舎者然としている
いやな予感が戰戰	≪불길한 예감이 ㄷㅡㄹ∬&≫	0
紅潮戰戰	≪홍조를 ㄸㅣㄴ∬&≫	0
洗いっこ戰戰	≪씻ㄴㅡㄴ∬&≫	0
怪訝と戰戰	≪의아스러ㅇㅜㄴ∬&≫	0
沸騰戰戰	≪끓ㄴㅡㄴ∬&≫	0
溺愛戰戰	≪몹시 사랑ㅎㅏㄴ∬&≫		0
仮組み戰戰	≪가조립ㅎㅏㄴ∬&≫		0
手離戰戰	≪손을 ㄸㅔㄴ∬&≫		0
見殺しに戰戰	≪죽게 내버려 ㄷㅜㄴ∬&≫		0
お世話戰戰	≪보살ㅍㅣㄴ∬&≫		0
眠戰戰	≪잠ㅈㅏㄴ∬&≫		0
従僕戰戰	≪굴복ㅎㅏㄴ∬&≫		0
お漏らし戰戰	≪오줌을 ㅆㅏㄴ∬&≫		0
お伺い戰戰	≪묻ㄴㅡㄴ∬&≫		0
デビュー戰戰	≪데뷔ㅎㅏㄴ∬&≫		0
鼻高高戰戰	≪의기양양ㅎㅏㄴ∬&≫		0
凜と戰戰	≪늠름ㅎㅏㄴ∬&≫		0
拝領戰戰	≪배령ㅎㅏㄴ∬&≫		0
ふにっと戰戰	≪말랑ㅎㅏㄴ∬&≫		0
手を抜くまいと戰戰	≪대충 하지 않으려 ㅎㅏㄴ∬&≫		0
一堂に会戰戰	≪한자리에 모ㅇㅣㄴ∬&≫		0
手助けを戰戰	≪도와ㅈㅜㄴ∬&≫		0
うっとり戰戰	≪넋을 잃게 만ㄷㅡㄴ∬&≫		0

//의성어, 의태어	PostFilter_@Hdor 4400
ヶにかっと	씨익하고	0	//にかっと笑う。
きょどきょど	흠칫흠칫∥t	0
ヶグチャグチャ	엉망진창	0
ヶばくっと	뻐끔하고	0
パパッと	파팍하고	0
ゴポゴポ	부글부글∥t	0
//ゴポゴポと
ヶどくりと	쿵하고	0
ヶぺしっと	찰싹하고	0
ヶへいへいと	네, 네라고	0
ヶがしっと	파악하고	0
ヶげしっと	툭하고	0
ヶポーッと	멍-하니	0
ヶじとりと	빤히	0

ボンヤリ	멍하니∥r	0
やんわり	부드럽게∥r	0
ぴたり	딱∥r	0
ぺたり	털썩∥r	0
ぴょん	뿅∥t	0
じゃばじゃば	첨벙첨벙∥t	0
ふわり	두둥실∥t	0
ニヤッ	히죽∥d	0	//ニヤっと笑う
ヶちらっちらっ	힐끔힐끔∥r	0
ヶどくん	두근∥t	0

グポグポ	꿀럭꿀럭	0

あらまあ	어머나	0	//あらまあ随分と上手ですこと

//さ
静謐さ梦名	평온함	1	//室内の静謐さに物怖じもせず、

ご都合主義	편의주의	0
//웃음
ぷくく	푸쿠쿠	0
ふっくく	훗쿠쿠	0
ぷっくく	풋쿠쿠	0

メスの顔	암컷의 얼굴	1
カウパー汁	쿠퍼액	1
修道着	수도복	1
シスター	시스터	1
すえた匂い	시큼한 냄새	1
//嘘つき	거짓말쟁이#M	1
天啓	하늘의 계시#M	1
女魔導師	여마도사#M	1
暴挙	폭거#M	1
柱頭	기둥머리#M	1
合致	일치@@	0
ゴミクズ	쓰레기#M	1
なまじ才能	어설픈 재능#M	1
化け狐	괴물여우#M	1
糞食え	엿 먹어	0
息の一吹き	입김 한 번	0
狐面	여우가면#N	1
知恵比べ	지혜겨루기#M	1
神狐	여우 신#M	1
酷暑	무더위#M	1
目前	코앞#M	1
艶聞	염문#M	1
数瞬	찰나#M	1
前途	앞길#M	1
等間隔	같은 가격#M	1
狐の面	여우가면#M	1
意気込み	기세#M	1
ターバン	터번#M	1
勝手	제멋대로	1
褒章	포상#M
クラン	클랜#M
立ち回り先	도망처#M
立回り先	도망처#M
//談	말#M
有耶無耶	유야무야#M
状態	상태#M	1
鍛冶師	대장장이#M
回数	횟수#M	1
忍術	인술#M
御前	어전#M
美丈夫	미남#M
心使い	마음씀씀이#M
あれ程	그렇게	0
ローパー	로퍼#M
角笛	뿔피리#M
襞状	주름모양#M	1
ドットコム	닷컴#M
長期休み	장기 휴일#M	//長期休みにしかできない経験や体験を
ポテンシャル	포텐셜#M
談話室	담화실#M
書き出し文	글의 첫머리#M
門前払い	문전박대
門前	문 앞#M
リアリズム	리얼리즘	1
輪まわし	굴렁쇠#M
小供	어린애#M
金切り音	쇳소리#M
トランポリン	트램펄린#M
ラストスパート	라스트 스퍼트#M
微塵	조금	0
眼力	안력#M
泡立ち石鹸	거품비누#M
サイクロン	사이클론#M
バニーガール	바니걸#M
レベルアップ	레벨 업#M
実力至上	실력 지상#M
至上	최상#M	0
レガシー	레거시#M
ぐぬぬ	흐으음	0
無体	무리	0
蜘蛛の糸	거미줄#M
薄笑み	엷은 미소
//坊や梦名	꼬맹이#M
うわ言	혼잣말#M
金切声	날카로운 소리#M	1
金切り声	날카로운 소리#M	1
霜降り肉	마블링#M
尊厳	존엄#M
尻朶	볼기#M
淫語	추잡한 말#M
ラインナップ	라인업#M
感心しきり	감탄의 연속
フルフェイス	풀 페이스#M
薄水色	옅은 하늘색
顔立ち	용모#M
愛好会	애호회#M
球の汗	구슬땀#M
化粧っ気	화장기#M
煽り文句	도발#M
後講釈	뒷북#M
講釈	설명#M
慰み物	노리개#M
杭打ち	말뚝박기
うひょお	우효오
ひょおお	효오오
タイ人	태국인
さらっとした口跡	가벼운 말투#M	1
どんぶり	돈부리#M	1
デッキ	덱#M
プレイング	플레이
ゴショウ	후추#M
一振りの剣	한 자루의 검
宝具	보구#M
剣型	검형#M
生垣	산울타리
ジェノサイダー	제노사이더#M
黒尽くめ	검정 일색
片手間	틈틈이
モトカノ	전 여친#M
草刈鎌	풀 베는 낫#M	1	VPe
紙皿	일회용 접시#M	1	VPe
断端	절단면#M	1
ファイティング	파이팅
怒号	고함#M
途上	도중
床板	마루바닥
床	바닥	//先生の床についた腕のひじが、なお深くなった。
ラフな格好	편안한 차림#M	0
日中	낮#M	1	UMe
箒梦名がけ	빗자루질#M	1
買い替え	교체
ハンバーグ	햄버그#M	1	VFd
スカジャン	스카쟌#M	1	VCp
擬音	효과음#M	1	UHr
バックミラー	백미러#M
どぶ	시궁창#M	1
エノキタケ	팽이버섯#M	1	VFd
懸命さ	노력#M	1
外鍵	바깥 자물쇠#M	1
燕返し	츠바메가에시#M	1
便座	변기#M	1
バンダム	밴텀#M	1
夕食どき	저녁식사 시간#M	UMe
靴あと	신발자국#M	1
参軍	참모#M	1
首の付け根	목덜미#M	1
御守り	부적#M	1
丸椅子	둥근 의자#M	1
灰塵	재와 먼지#M	1
何体	몇놈#M	1	//あと何体！？
卵形	달걀 모양#M	1
蛍光灯	형광등#M	1
血振り	피털기#M	1
冷めた目	싸늘한 눈#M	1
優しげ	상냥한##
幹事長	간사장#M	1
母君	어머님#M	1
靴先	구두코#M	1
越し	너머
樹木	수목#M	1
インプ	임프#M
千天万花	천천만화#M	1
武帝祭	무제제#M
大磯	오오이소#M	1	QCT
ヒューマン	휴먼#M	1	QNP
藪	수풀#M	0	VPt
後詰	후방 부대#M	1
リザードマン	리자드맨	//リザードマンでありながら太陽の神を信じる者もいる。
仕立て直	새로 지은 옷#M
はにかみ顔	수줍은 얼굴#M	1
腹黒	하라구로#M	1
隣端	옆 가장자리#M	1
封ろう	봉랍#M	1
自棄	자포자기#M	1
蜜月	밀월
蜜	꿀#M	1
プレイアブル	플레이어블#M	1
罅	금#M	1
絡み酒	술주정#M	1
ファントムペイン	팬텀 페인#M	1
フナムシ	갯강구#M	1
介護	간호#M	1
はやる気持ち	조급해지는 마음#M	1	UFl
ヒーリング	힐링#M	1
スケルトン	스켈레톤#M	1
アビス	어비스#M	1
アンデット	언데드#M	1
ハイコスト	하이코스트#M	1
ウィスプ	위습#M	1
スラスト	스러스트#M	1
パラライズ	패럴라이즈#M	1
エンプレス	엠프레스#M	1
エクストリーム	익스트림#M	1
カトラリー	커틀러리#M	1
シラバス	실라버스#M	1
ランバージャック	럼버잭#M	1
ノックバック	넉백#M	1
マスタリー	마스터리#M	1
友好大使	우호대사#M	1
地球儀	지구본#M	1
小局	소국#M	1
着せ替え人形	옷갈아입히기 인형#M	1
金の目	금빛 눈#M	1
瑠璃色	유리색#M	1
掃除婦長	청소부장#M	1
金将	금장#M	1
小松菜	소송채#M	1
鬣	갈기#M	1
横飛び	가로뛰기#M	1
別名義	다른 명의#M	1
疎開先	피난처#M
今風	현대풍#M	1
渋顔	떨떠름한 얼굴#M	1
男言葉	남자말투#M	1
ご飯どき	밥 먹을 때#M	1
事情通	소식통#M	1
マックス	맥스#M
フリーズ	프리즈#M
ノーダメージ	노 데미지#M
ダメージ	데미지#M
ノーダメ	노 데미지#M
きひひ	키히히
何百年	몇백년#M	1
刺突	찌르기#M	1
バイ菌	세균#M	1
モンペ	맘충#M	1
追求	추궁#M	1
レッドカード	레드 카드#M	1
強かな	억센	0
トドメ	결정타	#M
小花	작은 꽃#M	1	VPt
カルマ	카르마#M	1
テイム	테임#M	1
クリーン	클린#M	1
ヒース	히스#M	1
アナライズ	애널라이즈#M	1
仕業	소행	1
柄部分	손잡이 부분#M	1
単騎	단기#M	1
かんしゃく玉	울화통
リンゴ	사과#M
写メ	휴대폰 사진#M
一丁前	일인분
一丁	하나#M
潮時	적당한 때#M	1	UMe
ヌルゲー	쉬운 게임#M	1
ぬるゲー	쉬운 게임#M	1
無双ゲー	무쌍 게임#M	1
大増量	대증량
お節介している様子	참견쟁이#M	1	//お節介っぷり
顔役	유력자#M
レトルト	레토르트#M	1
チャリンコ	자전거#M	1
涙一つ	눈물 하나#M	1
夜の帳	밤의 장막#M
目まい	현기증#M	1
環状	원형
屈伸運動	스쿼트#M
ゴルゴンゾーラ	고르곤졸라#M
皮靴	가죽 구두#M
全然	전혀
双角	쌍 뿔#M
ひとセット	한 세트
黒雲	먹구름
波しぶき	파도 물보라
ラヴストーリー	러브스토리
一見客	처음 온 손님#M
馴染み客	단골손님
アップロード	업로드
深皿	깊은 접시
焦げ目	탄 자국
ナべ	나베
エミュレート	에뮬레이트
色恋沙汰	연애 얘기#M
スコア	스코어
鹿肉	사슴고기
ルーティン	루틴
冷ややつ	냉두부
人の気配	인기척
道導	이정표
豊麗線	팔자주름
見せ物	구경거리
キャリーケース	캐리어
ブービートラップ	부비트랩
肉盾	고기방패
デモゴルゴン	데모고르곤
ギャルゲー	미소녀 게임
オールオッケー	올 오케이	0
原稿用紙	원고지
筆記用具	필기구
離婚届け	이혼 서류
アイスコーヒー	아이스커피
無鉄砲	무모	1
中度	중도
白檀	백단
見場	겉모습
スリーピー	슬리피
酸化クロム	산화 크롬
コランダム	커런덤
カミングアウト	커밍아웃
餌代	먹이값
肘掛け	팔걸이
馬の蹄	말발굽
メイズ	메이즈
ホロウ	할로우
フルーツ味	과일맛
何個目	몇 개째
ガンバスター	건버스터
エンプティー	엠프티
フィニッシュムーヴ	피니쉬 무브
ウィンドウショッピング	윈도우 쇼핑
大崩壊	대붕괴
空返事	건성인 대답
名演説	명연설
付け睫	인조 속눈썹
派手目	화려한 것
対応方法	대응방법
ねずみ小僧	쥐새끼
カンスト	카운터스톱
念能力	넨 능력
消え物	소모품
ホールドアップ	홀드 업
平和	평화	0	//平和を望む心の持ち主でも
斜め前	대각선 앞
イランイラン	일랑일랑
イランイランノキ	일랑일랑 나무
令和	레이와
辨明	변명	1	//言い訳を重ねる
外骨格	외골격
トロ顔	토로가오
ウィンドウ	윈도우
メッセージウィンドウ	메시지윈도우
働き蜂	일벌
お鍋	냄비	1	VCk
内緒事	비밀
小口径	소구경
チョロイン	쵸로인
男女平等	남녀평등
ねんどろいど	넨도로이드
プロシュート	프로슈토
前部長	전 부장
末妹	막내 여동생
ドブソニアン	돕슨식
クライマックス	클라이맥스
鉤爪	날카로운 발톱
バックラー	버클러
カイトシールド	카이트 실드	0
お世話	참견	1
舌使い	혀놀림
学び舎の檻	학교 감옥
下校道	하굣길
完膚なきまでに	철저히	0
刺のある	가시 돋친	0
恋路	연애
鶏むね肉	닭가슴살
鶏胸肉	닭가슴살
中々	제법
身許	신원#M	1	VHn
ショール	숄
正立方体	정입방체
火矢	불화살
ベルベット	벨벳#M	1
冬山	겨울산
クランベリー	크랜베리#M	1
命綱	생명줄
二級	2급
一級	1급
若菜色	밝은 황록색
推しキャラ	최애 캐릭터
金糸雀	카나리아
理論学	이론학#M	1	USu
ニヤケ顔	히죽히죽 웃는 얼굴
コンプトン	콤프턴
ウィンカー	깜빡이
健康体操	건강 체조
赤光	붉은 빛
援交	원교
写真立て	액자
アルカナ	아르카나
火打ち石	부싯돌
背高椅子	키높이 의자
ドレスアップ	드레스 업
流行り病	유행병
桃園の誓い	도원결의
音ゲー	리듬겜
力作業	힘 쓰는 일
写真機能	사진 기능
イマジン	이매진
マスターキー	마스터 키
木の根本	나무의 근본
ゴム鞠	고무공
忠臣蔵	츄신구라
一対多数	일대 다수
アスパラ	아스파라거스
雄鶏	수탉
地雷原	지뢰밭

//悔しく	분하게	0	//테스트
危うく	겨우(하마터면)	0
働かね	일하지 않아	0	//테스트
悔しいとしか	분하다고 밖에	0	//せこいとしか
遮るった	차단한	0	//汀はナイフを振るったのだ

//장신구	VAc

//무기	VTw
アロンダイト	아론다이트#M	1	VTw
釘つきバット	못 박힌 배트#M	1	VTw
片手剣	한손검#M	1	VTw
鉄の剣	철검#M	1	VTw
ハルバード	할버드#M	1	VTw
ウォーハンマー	워해머#M	1	VTw
//의복	VCp
ブリガンダイン	브리건딘#M	1	VCp
ガントレット	건틀릿#M	1	VCp
黒衣	검은 옷#M	1	VCp
赤マント	붉은 망토#M	1	VCp

//신분,직업	UAq
甥御	조카#M	1	UAq
龍王	용왕#M	1	UAq
平騎士	평기사#M	1	UAq
準男爵	준남작#M	1	UAq
シーフ	시프#M	1	UAq
パラディン	팔라딘#M	1	UAq
中衛	중위#M	1	UAq
マフィア	마피아#M	1	UAq
メイドさん	메이드씨#M	1	UAq
番人	파수꾼#M	1	UAq
警吏	경찰관#M	1	UAq
男子高生	남고생#M	1	UAq
本売り	책장수#M	1	UAq
伯爵位	백작위#M	1	UAq
男爵位	남작위#M	1	UAq
公爵位	공작위#M	1	UAq
侯爵位	후작위#M	1	UAq
子爵位	자작위#M	1	UAq
マドモアゼル	마드모아젤#M	1	UAq
探偵	탐정#M	1	UAq	//一流探偵さんが
聖闘士	성투사#M	1	UAq	//

//장소	건축물VBl	장소VPl
芝生地	잔디밭#M	1	VPl
原野	들판#M	1	VPl
スラム街	슬럼가#M	1	VPl
スラム	슬럼#M	1	VPl
プールサイド	풀사이드#M	1	VPl
校門脇	교문 옆#M	1	VBl
ど田舎	깡촌#M	1	VPl
草叢	풀숲#M	1	VPl
闘技場	투기장#M	1	VPl
急勾配	급경사#M	1	VPl
沖合い	먼 바다#M	1	VPl
戸越し	문 너머#M	1	VPl
峠道	고갯길#M	1	VPl
丘上	언덕 위#M	1	VPl
全箇所	모든 곳#M	1	VPl
箇所	장소#M	1	VPl
階段口	계단 출입구#M	1	VPl
隘路	좁은 길#M	1	VPl
床屋	이발소#M	1	VPl
厩	마구간#M	1	VPl
廐	마구간#M	1	VPl
造り物	구조물#M	1	VBl
製薬	제약#M	1	VPl
服屋	옷가게#M	1	VBl

//신체부위
ペニス	페니스#M	1	VBp
おくちマンコ	입보지#M	1	VBp
ポルチオ	포르치오#M	1	VBp
指先	손끝#M	1	VBp
頸動脈	경동맥#M	1	VBp
頸静脈	경정맥#M	1	VBp
頸血	경혈#M	1	VBp
肉袋	고기주머니#M
肉びら	소음순#M	1	VBp
カリ首	귀두 아래#M	1	VBp
頸	목#M	1	VBp
襞	주름#M	1	VBp
脳髄	뇌수#M	1	VBp
子宮口	자궁구#M	1	VBp
春草	음모#M	1	VBp
豊尻	풍만한 엉덩이#M	1	VBp
切れ長の眉毛	길게 자른 눈썹#M	1	VBp
上の前歯	위의 앞니#M	1	VBp	//上の前歯が欠けているのがわかった。
蜜壷	꿀단지#M	1	VBp
右手の甲	오른손등#M	1	VBp
左手の甲	왼손등#M	1	VBp
右脚	오른다리#M	1	VBp
左脚	왼다리#M	1	VBp
内また気味の足	안짱다리#M	1	VBp
小脇	겨드랑이#M	1	VBp
横髪	옆머리#M	1	VBp
髪の毛先	머리카락 끝#M	1	VBp
巨根	거근#M	1	VBp
柳腰	날씬한 허리#M	1	VBp
片耳	한쪽 귀#M	1	VBp
首裏	목 뒤#M	1	VBp
小尻	작은 엉덩이#M	1	VBp

//이름
エニ	에니#N	1	VHn	//인간
オクトパス	옥토퍼스#N	1	VHn	//인간?
エルリーゼ	엘리제#N	1	VHn	//인간
カイゼル	카이젤#N	1	VHn	//인간
エミーリア	에밀리아#N	1	VHn	//인간
エミー	에미#N	1	VHn	//인간
エミ	에미#N	1	VHn	//인간
ヴィンス	빈스#N	1	VHn	//인간
レヴァン	레반#N	1	VHn	//인간
レイド	레이드#N	1	VHn	//인간
デズモンド	데스몬드#N	1	VHn	//인간
ヘンリー	헨리#N	1	VHn	//인간
ハロルド	해롤드#N	1	VHn	//인간
ロスマン	로스만#N	1	VHn	//인간
リチャード獅子心王	리처드 사자심왕#N	1	VHn	//인간
サラディン	살라딘#N	1	VHn	//인간
間島	마지마#N	1	VHn	//인간
エドモンド	에드몬드#N	1	VHn	//인간
エド	에드#N	1	VHn	//인간
フィオ	피오#N	1	VHn	//인간
ガイ	가이#N	1	VHn	//인간
エレオノーラ	엘레오노라#N	1	VHn	//인간
ラドミラ	라드밀라#N	1	VHn	//인간
チュンリー	춘리#N	1	VHn	//인간
三蔵法師	삼장 법사#N	1	VHn	//인간
ガリレオ	갈릴레오#N	1	VHn	//인간
ガリレイ	갈릴레이#N	1	VHn	//인간
ツェツィーリア	체칠리아#N	1	VHn	//인간
テオドール	테오도어#N	1	VHn	//인간
ローレンソン	로렌슨#N	1	VHn	//인간
ウェズリー	웨슬리#N	1	VHn	//인간
アルノー	아르노#N	1	VHn	//인간
シェリー	셰리#N	1	VHn	//인간
ベルファスト	벨파스트#N	1	VHn	//인간
イラストリアス	일러스트리어스#N	1	VHn	//인간
ベルン	베른#N	1	VHn	//인간
ジェロム	제롬#N	1	VHn	//인간
アレクサンドル	알렉산드르#N	1	VHn	//인간
ランスロット	란슬롯#N	1	VHn	//인간
鏡音	카가미네#N	1	VHn	//인간	鏡音リン
美樹本	미키모토#N	1	VHn	//인간
ダドリー	더들리#N	1	VHn	//인간
エミリア	에밀리아#N	1	VHn	//인간
エドワード	에드워드#N	1	VHn	//인간

//오역 위험 있음
//その癖	그럼에도	0
あろうことか	하필이면	0
有ろうことか	하필이면	0
はじめこそ	직후에는	0
従順な	순종적인	0
出場所	나설 자리#M	0
囚われの	붙잡힌	0
新米	신참	0
ツボ	급소#M
幾つも	여럿
幹部	간부#M
幹	줄기#M
自らの	자신의	0
シャレた	세련된
あのな	저기 말이야	0
伏目がちに	눈을 내리뜨고	0
伏目がち	눈을 내리뜸
女姿	여자 모습#M	1

心当り	짐작가는 곳#M
心当たり	짐작가는 곳#M

//문구
もう一つ道	또 하나의 길#M	0
唯一人	단 한사람#M	0
命懸けの	목숨을 건 	0
命がけの	목숨을 건 	0
猛然と	맹렬하게	0
無理無体に	강제로	0
うらめしや	원망스럽구나	0	//귀신 대사
そうこうしている内	그러는 동안#M	0
一心不乱に	일심불란하게	0
くぐもった声	우물거리는 소리#M
せめてもの救い	그나마의 위안	0
これ見よがし	보란 듯이	0
早口で	빠르게	0
婉曲的な	완곡한	1
神妙に	얌전하게	1
衣服の内	옷의 안
ひれ伏し	넙죽 엎드려	0
躊躇いがちに	주저하면서	0
齧りかけの	한 입 베어물은	0
くそったれな	빌어먹을	0
お世辞にも	빈말이라도	0
お望みの通り	원하시는 대로	0
神の如き	신과 같은	0
大体、	애시당초,	0
自ずと	저절로	0
神がかっていた	신들려있었다	0
びっくりだよ	놀랐다고	0
なにがなにやら	뭐가 뭔지	0
味が分からない	맛을 모르겠다	0 //焦りのせいか味がわからない
やる気なものようだ	할 생각인 것 같다	0
やる気なものようで	할 생각인 것 같아서	0
我慢なりません	참을 수 없습니다	0
使えもしない	##쓰지도 못하는	0
ためではなく	때문이 아니라	0
役に立ていない	도움이 되지 않는다	0
仕出かしたら	저지른다면	0
してもいないのに	하지도 않았는데	0
にも拘らず	그럼에도 불구하고	0
意に介することなく	개의치 않고	0
介することなく	개의치 않고	0
介する事無く	개의치 않고	0
うず高く	수북이	0
今回ばかりは	이번만큼은	0
余りいい手	그다지 좋은 수#M	0	//余りいい手とは思えないな
そもそも	애초에	0
並々ならぬ	예사롭지 않은	0
有無を言わさず	다짜고짜	0
判然としない	확실치 않다	0
試しとばかりに	시험삼아	0
早いもので	빠르게도	0	//早いものでもう終わろうとしています
同様に	마찬가지로	0
今度こそ	이번에야 말로	0
ご心配には及びません	걱정하실 것 없습니다	0
フレンドリーに	친근하게	0
気は使わず	배려하지 말고	0
願い虚しく	내심 기대했지만	0
接せば	접하면	0
同じくせに	같은 주제에	0
わかりきった	뻔한	0
分り切った	뻔한	0
わり切った	뻔한	0
分りきった	뻔한	0
抜き身の	뽑아 든	0	//抜き身の刀身
ゆくゆく	끝내	0

//유저사전
ヤブ医者	돌팔이 의사#M	1	UAq
肉達磨	고기 덩어리
老皇帝	늙은 황제#M	1	UAq
野武士	방랑무사#M	1	UAq
太刀さばき	칼솜씨
アへガオ	아헤가오
ヤリチン	야리칭
一波乱	일대 파란
準教授	준교수#M	1	UAq
人形遣い	인형사#M	1	UAq
ギャル	갸루
釣り堀	낚시터
遣いの者	심부름꾼
お腰	허리#M	1	VBp
ノーパソ	노트북
ワーウルフ	워울프
ランカー	랭커#M	1	UAq
コーデ	코디
マーメイド	머메이드
ツルマン	매끈보지#M	1	VBp
ガテン系	가텐계
下衆	쌍놈
阿呆んだら	바보
あほだら	바보
アホたれ	바보놈
クソジジイ	망할 할배
クソババア	망할 할망구
へちゃむくれ	병신
屁垂れ	겁쟁이
アバズレ	여편네
畜生め	짐승같은 자식
糞野郎	망할새끼
基地外	미친놈
へまやろう	얼간이
べらぼう	등신
ぼんやり者	멍청한 놈
おろか者	어리석은 놈
罰あたりめ	천벌 받을 놈
負け組み	루저
租チン	실좆
セン公	담탱이
メンへラー	멘헤라
脳タリン	저능아
知恵遅れ	똘아이
受動喫煙	간접 흡연
ビンカン	민감
仔供	아이
サカリ	발정
めすいぬ	암캐
女肉	여육
牝腰	암컷 허리#M	1	VBp
鬼頭	귀두
スミスアンドウェッソン	스미스 앤 웨슨
性の権化	성의 화신
フルチン	풀 발기
赤毛	빨간 머리#M	1	VBp
黒煙	검은 연기
鬼人	귀인
マクベス	맥베스
ナイル川	나일강
内腿	안쪽 허벅지#M	1	VBp
女王バチ	여왕벌
働きバチ	일벌
地元の人	현지인
玉にキズ	옥의 티
神主	신관#M	1	UAq
死の使い	죽음의 사자#M	1	UAq
抹茶	말차
薄朱色	밝은 주홍색
戦地	전쟁터
両手の平	양 손바닥#M	1	VBp
松ノ原	마츠노하라
生春巻き	월남쌈
定位置	제자리
赤の蠍	붉은 전갈
フランクな口調	솔직한 어조
イチゴオレ	딸기오레
ミックスオレ	믹스오레
バビロニア	바빌로니아
マスこっと	마스코트
ビュステンハルター	뷰스텐할터
籤引き	제비뽑기
人の使用人	남의 하인
人の屋敷	남의 집
コンドームッ	콘돔
裏垢	뒷계정
ネトラセ	네토라세
パート長さん	파트장님
逢魔が時	해질녘
ヒマツブシ	심심풀이
派出所	파출소
ハイジャック犯	납치범
天津	아마츠
天照	아마테라스
苦無	쿠나이
玉響	타마유라
閑散期	비수기
ジルコニア	지르코니아
元国語教師	전 국어 교사
親世代	부모 세대
書道部	서예부
背理法	귀류법
雌豹	암표범
立位	입위
イトコ	사촌
セイロンティー	실론티
ラビア	음순#M	1	VBp
顎髭	턱수염#M	1	VBp
パイオツ	슴가#M	1	VBp
上級の反物	고급 원단
マジイキ	진심절정
大番狂わせ	대반란
媚薬液	미약액
家畜小屋	마구간#M	1	VPl
オッズ表	승률표
豚小屋	돼지우리#M	1	VPl
自軍	아군
腰奥	허리 안쪽#M	1	VBp
アナフィラキシーショック	과민성 쇼크
じゃじゃ馬	말괄량이
三連星	삼연성
ヴァルキューレ	발키리
クロマニヨン人	크로마뇽인
おねショタ	오네쇼타
おじロリ	오지로리
アナウンス	아나운스
わんちゃん	강아지
仮の公用語	임시 공용어
ドラ焼き	도라야키
巻き玉子	달걀말이
割りチケット	할인 티켓
割りチケ	할인 티켓
爆乳娘	폭유녀
手マンコ	손 보지#M	1	VBp
テレビ局	방송국
インラン	음란
丸眼鏡	둥근 안경
凍京	도쿄#M	1	VPl
凍京都	도쿄도#M	1	VPl
凍京都知事	도쿄도지사#M	1	UAq
副凍京都知事	부도쿄도지사#M	1	UAq
ネクロマンシー	네크로맨시
ネクロマンサー	네크로맨서#M	1	UAq
ケジラミ	사면발이
潮吹き	시오후키
エンゲージリング	약혼반지
ハイソックス	하이 삭스
ロココ調	로코코풍
咽喉	목구멍#M	1	VBp
喜声	기쁜 목소리
黒スト	검정 스타킹
太股	허벅지#M	1	VBp
プレイス	플레이스#M	1	VPl
甘いかおり	달콤한 향기
フォーリンラブ	폴 인 러브
前脚	앞다리#M	1	VBp
侍大将	사무라이 대장#M	1	UAq
文字列	문자열
コーヒーミルク	커피 우유
スワッピング	스와핑
高いビル	높은 빌딩#M	1	VPl
リサイクル品	재활용품
フルハイビジョン	풀HD
女性社員	여직원
既成事実	기정 사실
カリクビ	귀두경부#M	1	VBp
カリフラワー	콜리 플라워	
購入元	구입처	1
暗路	어두운 길	1
狭路	좁은 길	1
下肢	다리#M	1	VBp
脹ら脛	종아리#M	1	VBp
町女	마을 여자
成り上がり王	벼락 출세 왕	1
成り上がり者	벼락 출세자	1
法悦	황홀한 기분	1
リバイアサン	리바이어던
乳姫	젖공주	1
初体験	첫경험	1
にぶちん	둔탱이	1
ニブチン	둔탱이	1
喧伝	선전	1
夜闇	어두운 밤	1
直方体	직육면체	1
薄着	얇은 옷	1
干しダラ	말린 대구	1
糞アマ	망할년	1
後部サドル	뒷 안장	1
悪魔め	악마놈	1
舌戯	혀 애무	1
仏陀	부처	1
ヤム芋	참마	1
騎士長さん	기사장님	1
孕み姫様	임신공주님	1
ゾウリムシ	짚신벌레	1
清水寺	기요미즈사	1
代返	대리출석	1
サーモグラフィー	온도 기록계	1
イキ地獄	절정지옥	1
ハイトーン	하이톤	1
豚鼻	돼지 코	1
ポリネシアンセックス	폴리네시안 섹스	1
肉ひだ	고기 주름	1
冷や麦	냉국수	1
バストアップ	바스트 업	1
三大本能	3대 본능	1
大目的	큰 목적	1
生脚	맨다리	1
悪魔払い	퇴마의식	1
悪魔祓い	퇴마의식	1
クォンタム	퀀텀	1
日本晴れ	쾌청	1
クレヴァス	크레바스	1
女癖	여벽	1
恒例行事	연례행사	1
妻帯者	유부남	1
眼精疲労	눈의 피로	1
ヨガリ	교성	1
婦人部	여성부	1
カップ麺	컵라면	1
巨チン	큰자지	1#M	1	VBp
隠し芸	장기자랑	1
ナース	간호사	1
大臀筋	대둔근	1
キモヲタ	씹덕	1
洗濯かご	빨래 바구니	1
酒器	술잔	1

//모에사전
公王様	공왕님#M	1	UAq
コボルド	코볼드
おねえたん	언니야
おにいたん	오빠야
焼き餅	질투#M
子供の頃	어렸을 때#M	1
真面目な話	진지한 이야기
妃殿下	왕비 전하
コミュ障	커뮤장애
バックスタッブ	백스탭
銀狼	은랑
蜜壺	꿀단지
ヴィクトリアン	빅토리안
キャラクエ	캐릭 퀘스트
残りスキルポイント	남은 스킬 포인트
ジョブチェンジ	잡 체인지#M
ジョブ	직업#M
布鎧	천갑옷#M
獣魔術	수마술#M
エリクシール	엘릭서
エリクサ	엘릭서
アッシュ	애쉬
遠射	멀리서 사격#M
曲射	곡사
スキャンティ	스캔티
ミラージュアタック	미라쥬 어택
クロースアーマー	크로스 아머
パリィ	패리
護衛獣	호위수#M
フリージングコフィン	프리징 코핀
ドラゴンハウル	드래곤 하울
つり目がち	찢어진 눈#M
ブサメン	추남#M

しゅうとめ	시어머니(장모)#M
ブスドル	추녀돌#M
花やら	꽃들
オコジョ	족제비#M
ウミウぃ	가마우지#M
ハクセきれい	흰 할미새#M
コノハズク	소쩍새#M
アオサギ	왜가리#M
ルリチョウ	큰유리새#M
ヒレンジャク	홍여새#M
漂鳥	떠돌이새
留鳥	텃새
近習	측근#M
染職人	염직공#M	1	UAq
口先男	아부남	
イイヤツ	좋은 녀석
メイ道	메이道
ネトウヨ	넷우익
まい泉	마이센
イタメシ屋	이태리 식당
アフロ	아프로
テキ屋	잡상인
オペラ座の怪人	오페라의 유령
結活	결혼활동
泥土	진흙
豚テキ	포크 스테이크
拇印	지장
帆立貝柱	가리비 관자
夜討	야습
御神籤	운수 제비
アキレス	아킬레스#N	1	VHn	//인간
あんきも	아귀 간
あん肝	아귀 간
カリヨン	카리용
オサラバ	작별#M	1
ささみ肉	닭가슴살
なんこつ	연골
オミクジ	오미쿠지
こっくりさん	분신사바
絢爛	현란
藪蛇	긁어 부스럼
カメムシ	방귀벌레
インパラ	임팔라
桃缶	복숭아 통조림
犬かき	개헤엄
砂風呂	모래찜질
下流域	하류지역
ボブカット	보브컷
鳥カツ	치킨 커틀릿
小等部	초등부
身の振り方	처신#M	1
スロットル	스로틀
ふし穴	옹이 구멍
トイレ紙	화장지
薄型	얇은
片笑み	희미한 웃음
牝乳	젖탱이
シャマル	샤멀
シグナム	시그넘
ミッドチルダ	미드칠더
路駐	노상 주차
キクラゲ	목이버섯
靴箱	신발장
ドレミファソラシド	도레미파솔라시도
急場しのぎ	임시변통
紫小花	천일화
半地下	반지하
無茶	무리
アップデイト	업데이트
エセイケメン	사이비 미남
スティックノリ	딱풀
ゆめっち	유멧찌
ゆめゆめ	유메유메
ひかりん	히카링
ロジカルダッシュ	로지컬 대쉬
キャンセリング	캔슬링
バラエテ番組	버라이어티 방송
チンゲンサイ	청경채
イカロス	이카로스
さおぴょん	사오뿅
杏林	쿄우린
ボッティチェリ	보티첼리
テレピン油	테레핀유
カワハギ	쥐치
ウエット	웨트
ふぐ刺し	복어회
艶之小路	아데노코우지
マルバツ	OX
すじ肉	힘줄살
フライア	플라이어
百物語	돌아가며 하는 괴담
絹ごし	비단두부
しらたき	실곤약
オデン	오뎅
アオダイショウ	구렁이
ニホンマムシ	일본 살무사
遮蔽物	차폐물
ニックネム	닉네임
ホリデイ	홀리데이
キルスイッチ	긴급 엔진 정지 스위치
京料理	교토요리
デング熱	뎅기열
カキフライ	굴 튀김
キンパツ	금발
中トラ	중형트럭
軽トラック	경트럭
軽トラ	경트럭
アイソメトリクス	아이소매트릭스
チリドッグ	칠리도그
アサルト	어설트
原寸大	등신대
ジギタリス	디기탈리스
りゅうつう	유통
ろうどく	낭독
世界長	세계장
思案	궁리
ハワイコナ	하와이코나
うさぴょん	우사뿅
都市町	도시마을
アクセルペダル	액셀 페달
さつまりん	고구마링
ワンセグ	지상파DMB
ロシアンやき	러시안 야키
コクゾウムシ	쌀벌레
ウツボカズラ	벌레잡이통풀
レディコミ	여성향
鯉の穴	잉어굴
虎の穴	호랑이굴
エログロ	에로틱 그로테스크
小テスト	쪽지시험
オノマトペ	의성어
ティカップ	찻잔
カリ高デカチン	귀두가 엄청 큰 자지
デカチン	왕자지
メガチン	메가 자지
亡骸	유해
捨てアド	일회용메일
練習台	연습상대
ポテトフライ	감자 튀김
ねぎま	닭 파 꼬치
果物盛り合わせ	해물파전
たこのお刺身	문어숙회
すましじる	맑은 장국
すしべん	도시락 초밥
フルボイス	풀 보이스
家庭習	가정학습
角煮	간장조림
甘ったるいコロン	향긋한 향수
格技	격투기
見立て殺人	대역살인