//※필터링 때문에 변경된 문자열을 등록하는 경우에는 ♞표시.

//※ABAB형 부사는 ABAB 등록하고, ABABAB까지 등록해야 한다.

//█████████████████████████████████████████████████████████████████████████████
// 4.감동사, 인사 등 :
//█████████████████████████████████████████████████████████████████████████████

//#.상용어구로 등록 (감)
//▀▀▀▀▀▀▀▀▀▀▀▀▀▀▀▀▀▀▀▀▀▀▀▀▀▀▀▀▀▀▀▀▀▀▀▀▀▀▀▀▀▀▀▀▀▀▀▀▀▀▀▀▀▀▀▀▀▀▀▀▀▀▀▀▀▀▀▀▀▀▀▀▀▀▀▀▀
鬼さん此方	술래씨 이쪽이야	0
集まれやい	모여라	0
淫らを	추잡함을	0	//なんともいえん淫らを醸し出しとる
やさぐれ	자포자기	0	//やさぐれ女。やさぐれ女のひとりディズニー
猫も杓子も	개도 고양이도	0
一時なりとも	한 때일지라도	0
可愛いが格好いいに	귀여움이 멋짐으로	0
わずかではあるが	얼마 안 되지만	0
是非を	시비[是非]를	0
お引取り下さい	물러가 주세요	0
いわずと知れた	말할 것도 없는	0
お越し下さいませ	오셔 주십시오	0
目も合わせずに	눈도 맞추지 않고	0
他人ごとのように	남의 일처럼	0
あいたさ見たさに	만나고 싶고 보고 싶어서	0
会いたさ見たさに	만나고 싶고 보고 싶어서	0
やまやまなんだが	마음은 굴뚝이지만	0
力みのない	허세 없는	0
それはありですね	그건 있군요	0
一人でも二人でもなく	혼자도 둘도 아닌	0
古来より	예로부터	0
見た目に寄らず	겉모습과는 다르게	0
一度足りとも	한 번만이라도	0
なんたらかんたら	이러니 저러니	0
何たらかんたら	이러니 저러니	0
すれどもすれども	해도 해도	0	//訓練すれどもすれどもそれ以上、
比ぶべくも	비교할 수도	0
君子危うきに近寄らず	군자는 험한 곳에 가지 않는다	0
彼れを知りて己を知れば	지피지기면	0
百戦して殆うからず	백전불패	0
だれもかれも	그 누구나	0
猫ふんじゃった	고양이 밟아 버렸다	1
ねこふんじゃった	고양이 밟아 버렸다	1
物は言いよう	말은 하기 나름	1
ものは言いよう	말은 하기 나름	1
ものは言い様	말은 하기 나름	1
物は言い様	말은 하기 나름	1
物も言いよう	말도 하기 나름	1
ものも言いよう	말도 하기 나름	1
ものも言い様	말도 하기 나름	1
物も言い様	말도 하기 나름	1
我が事成れり	내가 할 일은 끝났다	0
我が事終われり	내가 할 일은 끝났다	0
見忘れはごもっとも	몰라 보시는 것은 당연합니다	0
見忘れもごもっとも	몰라 보시는 것도 당연합니다	0
三日とあけず	사흘이 멀다하고	0
三日とあけずに	사흘이 멀다하고	0
へっくち	헤엣취	0
授かりの	내려주신	0	//授かりの巡り合わせ
純白い	새하얀	0	//純白き
ナカヨク	사이 좋게	0
どうたらこうたら	이렇다느니 저렇다느니	0
どうたら	어떻다느니	0	//またどうせ、王がどうたらということに決まっているのだから。
どのすれば	어떻게 하면	0
さまよいの	헤매임의	0
覚悟めされよ	각오하시오	0
安心めされよ	안심하시오	0
力足りずに	힘이 충분하지 못하고	0
力足りず	힘이 충분하지 못하고	0
暮れかけの	저물기 시작한	0
時を追うごとに	시간이 지날수록	0
年を追うごとに	해를 거듭할수록	0
日を追って	나날이	0
食さず	먹지 않고	0
食さずに	먹지 않고	0
出掛けに	나가려는 참에	0
出かけに	나가려는 참에	0
出がけに	나가려는 참에	0
かる～く	가볍~게	0
白日の下に	백일하에	0
立ち上がりざまに	일어서자마자	0
翼下に	날개 밑에	0
後生だから	제발이니까	0
つかず離れず	붙지도 떨어지지도 않음	0
付かず離れず	붙지도 떨어지지도 않음	0
即かず離れず	붙지도 떨어지지도 않음	0
時分柄	때가 때이니만큼	0
見つかりさえすれば	찾아내기만 하면	0
わが校きっての	우리 학교 최고의	0
我が校きっての	우리 학교 최고의	0
偉大なりし	위대한	0	//偉大なりしモンゴル帝国。なりし 일괄 처리 모색해볼 가치 있음.
我も我もと	너도 나도	0
ほうほうの体	헐레벌떡	1
ほうほうの体で	헐레벌떡	0
事ある事に	일 있을 때마다	0
弥増しに	더욱 더해	0
いや増しに	더욱 더해	0
幸いなる哉	다행스럽게도	0
幸いなるかな	다행스럽게도	0
容赦なくなる	가차없이	0
容赦なくて	가차없어서	0
結論ありきで	결론지어진 것처럼	0
とてつもなき	터무니 없는	0
出会いがしらに	만나자마자	0
介さなければ	개의치 않으면	0
メシマズ	밥 맛없어	0
飯マズ	밥 맛없어	0
面下げて	낯짝으로	0
面を下げて	낯짝으로	0	//どの面を下げて
どの面下げて	무슨 낯짝으로	0
どの面を下げて	무슨 낯짝으로	0	//どの面を下げて
死にもの狂い	죽자살자	1	//死にもの狂いで食ってかかる
儘にならぬが浮世	뜻대로 되지 않는게 속세	1
有りか無しか	있는가 없는가	0
承知致しました	알겠습니다	0
何から何まで	하나에서 열까지	0
隠れ場ごと人を	숨은 곳째로 사람을	0
このうえない	이 이상 없는	0
この上無い	이 이상 없는	0
好むと好まないとに	좋아한다 좋아하지 않는다에	0	//♞好む好まざるにかかわらず
好む好まないに	좋아한다 좋아하지 않는다에	0	//♞好む好まざるにかかわらず
呪われろ	저주 받아라	0
機嫌とり兼	기분 맞출 겸	0
機嫌取り兼	기분 맞출 겸	0
渇すれども	갈증은 나는데	0
声はすれども	소리는 나는데	0
嫌がらせのように	괴롭히듯이	0
いやがらせのように	괴롭히듯이	0
いのちだいじに	생명 소중하게	0
気付きのように	눈치챈 것처럼	0
力付くでも	힘으로라도	0
力付くで	힘으로	0
知っての通り	알고 있는대로	0
およばずながら	미흡하게나마	0
やめなって	그만두라고	0
やめなってば	그만두란 말야	0
旅は道連れ世は情け	여행은 길동무 세상은 인정	0
東勢百万と候え	관동 백만이라 하나	0	//東勢百万と候え、男はひとりもなく候
遠水は近火を救わず	먼 물은 가까운 불을 끌 수 없다	0
備えあれば憂い無し	준비되어 있으면 걱정 없음	0
枯れ木も山の賑わい	고목도 산에 운치를 더한다	0
貧すれば鈍する	가난해지면 성품도 떨어진다	0
下手の考え休むに似たり	서툰 자의 생각은 쓸모가 없다	0
男女七歳にして席同じうせず	남녀칠세부동석	0
住めば都	정들면 고향	0
義を見てせざるは	의를 보고 행하지 않음은	0	//義を見てせざるは勇なきなり
勇なきなり	용기 없음이다	0
敵を知り己を知れば	적을 알고 나를 알면	0
百戦危うからず	백번 싸워도 위태롭지 않음	0
あっそうそう	앗 맞다맞다	0	//「あっそうそう！明日、朝練で起こしにいけないからねー！！」あっそうそう地震大丈夫？
容易ならぬ	용이하지 않은	0	//外には容易ならぬ敵がおり、　身には軽からぬ傷。
然り乍ら	그렇기는 하나	0
酔ひもせず	취하지도 않고	0
覚えずに	기억하지 못하고	0	//親しみを覚えずにはいられない。パスワードは“覚えずに”管理せよ! 
然るのち	그런 후	0	//体調を回復させ、然るのち樹海を探索する
あれなくば	저것 없으면	0
これなくば	이것 없으면	0
それなくば	그것 없으면	0
お互いのための	서로를 위한	0	//お互いのための別れ。
すっこんどれ	꺼져라	0	//거의 이렇게 쓰이는 듯 하다.
わからいでか	모를까 보냐	0
一緒にいようね	함께 있자	0
わけわかめ	영문을 모름	1
例にも漏れず	예외도 없이	0
予想だに	예상조차	0	//予想だにせぬ。
夢にだに	꿈에조차	0	//夢にだに見ず。
微動だに	미동조차	0	//微動だにしなかった。
犬だに	개조차	0	//犬だに恩を知る。
名こそ惜しけれ	이름이야말로 아깝도다	0
我関せず	나는 상관없음	0
いようがいまいが	있든지 없든지	0
口八丁手八丁	말도 잘하고 솜씨도 좋음	0
受ける受けない	받는다 받지 않는다	0	//基本的に受ける受けないは自由。
どげんかせんと	어떻게든 하지 않으면	0
どげんかせんといかん	어떻게든 하지 않으면 안 된다	0
触れなば切れない	건드리면 베인다	0	//♞触れなば切れん
触れなば落ちん	건드리면 떨어진다	0
ブッとんだ	정신 나간	0	//거의 이 뜻으로 쓰이는 것 같다.
ぶっとんだ	정신 나간	0	//거의 이 뜻으로 쓰이는 것 같다.
偶然としては	우연으로 해서는	0
おっつかれさま	수고하셨어요	0
然にあらず	그렇지는 않음	0	//♞然に非ず
ごらんの有様	보시는 모양	1	//ごらんの有様だよ！
串刺しにしたり	꼬치로 하거나	0	//串刺しにしたりして。
ツッコミつつ	츳코미 하면서	0	//男の子ならではの感性にツッコミつつも
斯くや	이러할까	0	//연어라고 한다. 極楽も斯くやと思われる別世界
言い知らない	말할 수 없는	0	//♞言い知れぬ
何時ものような	언제나와 같은	0
何時ものように	언제나처럼	0
否でも応でも	좋든 싫든	0
有難うございました	감사했습니다	0
悪堕ち	악에 떨어진	0
闇堕ち	어둠에 떨어진	0
打倒しなければ	타도하지 않으면	0	//打倒す 등록 때문에 오류.
念じろ	빌어라	0
念じろよ	빌어라	0
落ち着きなよ	침착해라	0
気味ながら	기미이면서	0	//やや引き気味ながら
柔よく剛を制す	부드러움은 강함을 이긴다	0
死なれでも	죽기라도	0
死なれでもしたら	죽기라도 하면	0	//死なれでもしたらたまったもんじゃない。
承知仕りました	알겠습니다	0
知ってかしらずか	아는지 모르는지	0
満たず	미치지 못하고	0	//領主が指定した魔力量に満たず
あれですら	저걸로조차	0
これですら	이걸로조차	0
それですら	그걸로조차	0
なんてたって	뭐라해도	0
出っ張て	튀어나와	0	//필터라인으로 입력할 필요 없을 듯. 全身ガリガリなのに腹だけ出っ張ている状態に近い。
無理に無理を	무리에 무리를	0
見つかりでも	발견되기라도	0	//裸でベッドにいるところを見つかりでもしたら
どうぞごひいきに	아무쪼록 잘 부탁해요	0
いざ知らず	모르겠으나	0	//子供のしわざならいざ知らず
体裁構わず	체면 없이	0
居たたまらず	더는 참지 못하고 	0
気のきいた	재치있는	0
いかがでございましょう	어떠할는지요	0
分からんちん	몰라	1	//사투리라고 한다.
人の風見てわが風直せ	남을 보고 자신을 고쳐라	0
人の風見て我が風直せ	남을 보고 자신을 고쳐라	0
人のふり見て我がふり直せ	남을 보고 자신을 고쳐라	0
人のふり見てわがふり直せ	남을 보고 자신을 고쳐라	0
その中を	그 안을	0
ばれたらばれたで	들킨다면 들킨걸로	0
いわんこっちゃない	말했잖아	0
ねぇってば	이봐요 참	0
山の如し	산과 같이	1
お気の毒でした	죄송했습니다	0
生ある限り	살아 있는 한	1
生あるうちに	살아 있는 동안에	1
仰いで天に愧じず	하늘을 우러러 부끄러움 없다	0
何の面下げて	무슨 낯짝으로	0
どの面下げて	어느 낯짝으로	0
拍手のひとつでも	박수 한 번이라도	0
理由であえて	이유로 굳이	0	//日本語は堪能だが、面白いからという理由であえて奇妙な言い回しを用いる。
とりもなおさず	즉	0
言葉少なに	말 없이	0
お近づきに印に	가까워지자는 의미로	0
情けは人の為ならず	인정은 남을 위한 것이 아님	0
情けは人のためならず	인정은 남을 위한 것이 아님	0
撃ちてし止まむ	치고야 말리라	0
三鳥も四鳥も	삼조도 사조도	0	//一石で三鳥も四鳥も狙えちゃう
毒も食らわば皿まで	독도 먹는다면 접시까지	0
毒もくらわば皿まで	독도 먹는다면 접시까지	0
毒を食えば皿まで	독을 먹으려면 접시까지	0
毒を食らわば皿まで	독을 먹는다면 접시까지	0
毒をくらわば皿まで	독을 먹는다면 접시까지	0
毒食らわば皿まで	독을 먹는다면 접시까지	0
気が早うございます	성격이 급하십니다	0
見ず知らずの	낯선	0	//見ず知らずの人の家
ご機嫌うるわしゅう	안녕하시길	0
ようこそお越し下さいました	잘 오셨습니다	0
ようこそおいで下さいました	잘 오셨습니다	0
承知つかまつりました	알겠습니다	0
ぶっちゃけ	까놓고	1	//ぶっちゃけ言おう。
こなたかなた	이쪽저쪽	0
上手かろうが下手だろうが	능숙하든 서투르든	0
遥か先に	아득히 앞에	0
御存じのとおり	아시는 바와 같이	0
御存じの通り	아시는 바와 같이	0
何となしに	왠지 모르게	0
お互いにとって	서로에게 있어	0
なすがまま	하는 대로	1	//彼らはいつ何時彼らを通報するかもしれない密告者たちのなすがままだった
然も無ければ	그렇지 않으면	0
然もなければ	그렇지 않으면	0
もう一個の	또 하나의	0	//大きな問題はもう一個の方なのだ。
いつもの様に	언제나처럼	0
いつもの様な	언제나 같은	0
曲りなりにも	그럭저럭	0
至れり尽せり	더할 나위 없음	1
至れり尽くせり	더할 나위 없음	1
至れりつくせり	더할 나위 없음	1
いたれりつくせり	더할 나위 없음	1
わからずとも	모르고라도	0
分からずとも	모르고라도	0
居ても立っても居られず	안절부절 못하고	0
さっきのだって	조금 전 것이라도	0
他にだって	그 외에도	0	//他にだって、何かしらしていれば、魔術で再現できただろう。
見るまに	순식간에	0
いたいのいたいのとんでけ	아픈거 아픈거 날아가라	0
いたいのいたいのとんでけー	아픈거 아픈거 날아가라	0
いたいのいたいのとんでゆけ	아픈거 아픈거 날아가라	0
痛いの痛いのとんでけ	아픈거 아픈거 날아가라	0
後悔先に立たず	후회막급	0
死なば諸共	죽으려면 다 같이	0
死なばもろとも	죽으려면 다 같이	0
寝ても覚めても	자나깨나	0
だまらっしゃい	조용히 하세요	0
黙らっしゃい	조용히 하세요	0
片っぱしから	닥치는대로	0
舌ったらず	설명이 불충분함	0
万事窮す	만사 끝나버림	1
舌っ足らず	설명이 불충분함	1
お願いしたします	부탁 드립니다	0
おねがいしたします	부탁 드립니다	0
お願いしたしました	부탁 드렸습니다	0
おねがいしたしました	부탁 드렸습니다	0
意に介さず	개의치 않고	0
意に介さずに	개의치 않고	0
酌はたぼ	잔은 여자가 따라야 제 맛	1
過ぎたるは猶及ばざるが如し	지나침은 모자람과 같다	0
偶然ながらも	우연히도	0
驚くなかれ	놀라지 마시라	0
驚く勿れ	놀라지 마시라	0
亀の甲より年の功	귀갑보다는 연공	1
三十六計逃げるにしかず	삼십육계 줄행랑이 제일	0
お聞きの通り	들으신대로	0
お聞きのとおり	들으신대로	0
いいっこなし	불평 없음	0
言いっこなし	불평 없음	1
少年老い易く学成り難し	소년 늙기 쉽고 배우기는 어렵다	0
少年老い易く学成り難しい	소년 늙기 쉽고 배우기는 어렵다	0
心頭滅却すれば火もまた涼し	심두멸각하면 불조차 시원함	0
心頭滅却すれば火もまた涼しい	심두멸각하면 불조차 시원함	0
思い立ったが吉日	생각난 지금이 길일	1
当たらずとも遠からず	맞은거나 다름없음	0
当たらずと雖も遠からず	맞은거나 다름없음	0
当たらずといえども遠からず	맞은거나 다름없음	0
将を射んとすればまず馬を射る	장수를 쏘려면 먼저 말을 쏴라	0
将を射んと欲すれば先ず馬を射よ	장수를 쏘려면 먼저 말을 쏴라	0
将を射んと欲すればまず馬を射よ	장수를 쏘려면 먼저 말을 쏴라	0
声はすれども姿は見えず	소리는 나는데 모습은 안 보인다	0
渇すれども盗泉の水を飲まず	갈증이 나도 도천물은 안 마신다	0
男女七歳にして同衾せず	남녀칠세 부동석	1
馬子にも衣装	옷이 날개	1
是非に及ばず	부득이 하게	0
是非におよばず	부득이 하게	0
聞いた限りでは	들은 바로는	0
聞いた限り	들은 바	0
どんとこい	얼마든지 와라	0
どんと来い	얼마든지 와라	0
きたるべき	다가올	0	//연어 : "와야 한다" 보다는 이렇게 쓰는게 맞다.
来たるべき	다가올	0	//연어 : "와야 한다" 보다는 이렇게 쓰는게 맞다.
むくつけき	험상궂은	0	//연어 : むくつけき野郎ばかりの我ら水泳部において、満場一致で『イケメン』の称号を贈られる数少ない人種である。 
いざ尋常に	자 정정당당하게	0
ごらんの通り	알고 계시는 대로	1
くるならこい	올테면 와라	0
如何様にでも	어떻게라도	0	//いかようにでも考えられる。
如何様にも	어떻게라도	0	//いかようにも考えられる。
如何様な	어떠한	0	//いかような姿を取らせる事も出来る。
//こんなので	이런 것으로	0	//** こんなのです。こんなのですね。
おちゃらけた	익살스러운	0
あらためまして	재차	0	//あらためまして、３年生の牧瀬皐月です
改めまして	재차	0	//あらためまして、３年生の牧瀬皐月です
これでもかってくらい	엄청날 정도	0	//これでもかってくらいに緊張していた。
//だめ元で	밑져야 본전으로	0	//だめでもともと의 약어라고 한다. : どうせ殺されるなら、ダメ元で聞いてみようかと思ってさ
//だめもとで	밑져야 본전으로	0
//だめ元	밑져야 본전	1
//だめもと	밑져야 본전	1
できもするが	할 수도 있지만	0
できもするけれど	할 수도 있지만	0
できはするが	할 수는 있지만	0
できはするけれど	할 수는 있지만	0
相違ありません	틀림 없습니다	0
それしきで	그까짓 걸로	0	//それしきで怒るような方では
またいらっしゃってね	또 와주세요	0
また、いらっしゃってね	또, 와주세요	0
武士は食わねど高楊枝	무사는 굶고도 먹은체 하는 법	0
武士は食わねど高ようじ	무사는 굶고도 먹은체 하는 법	0
午前中のうちに	오전 중에	0
幸せそうなら	행복한 것 같으면	0
間違いございません	틀림 없습니다	0
間違いございませんよ	틀림 없어요	0
めんどくさがらず	귀찮아 하지 않고	0
めんどくさがらずに	귀찮아 하지 않고	0
面倒臭がらず	귀찮아 하지 않고	0
面倒臭がらずに	귀찮아 하지 않고	0
見かけによらず	겉보기와는 달리	0
気にくわんが	마음에 들지 않지만	0
気にはくわんが	마음엔 들지 않지만	0
それについてなんだけど	거기에 대해서 입니다만	0
それについてなんですが	거기에 대해서 입니다만	0
読んで字のごとく	쓰여진 바와 같이	0
読んで字の如く	쓰여진 바와 같이	0
あおむけに	위를 향해	0
あてどもなく	정처없이	0	//校内をあてどもなくうろつき、
あと一息	이제 한 고비	1
あの人はあの人で	그 사람은 그 사람대로	0
あるのかないのか	있는 것인가 없는 것인가	1
あるものですからね	있으니까요	0
あるんだかないのか	있는건지 없는건지	0	//♞あるんだかないんだか。
あるんだかないんだか	있는건지 없는건지	0	//両手で、あるんだかないんだか微妙なおっぱいを揉む。
いいか悪か	좋은가 나쁜가	0
いかがかね	어떨까요	0
いか程ですか	얼마 정도입니까	0	//お代はいかほどですか。
いか程ですかね	얼마 정도일까요	0	//お代はいかほどですかね。
いざとなれば	여차하면	0
いずれがいずれに	어느쪽이 어느쪽에게	0
いずれがいずれの	어느쪽이 어느쪽의	0
いただきとうございます	주시기를 원합니다	0
イチかバチか	흥하든 망하든	0
いつだってでも	언제라도	0
いつになったら	언제쯤이면	0
いやというほど	싫다고 할만큼	0	//彼女が頑固であることは今までの付き合いでいやというほど分かっている。
うらやまけしからん	부러워서 참을 수 없음	0
おかまいなしに	상관치 않고	0
おしゃべりでも	수다라도	0	//おしゃべりでもしてる。
おやすみなさい	잘 자요	0
お見知りおきを	알아두시를	0
お気になさらずに	신경쓰지 마시도록	0
お気遣いなく	사양 않고	0
お気遣い無く	사양 않고	0
お待ちなさい	기다리세요	0
お渡しいたしました	인도했습니다	0
お渡しいたします	인도합니다	0
お忘れのないように	잊지 않도록	0
お腹すいたら	배 고프면	0
お付き下さい	앉으세요	0
お付き下さいませ	앉아주십시오	1
お好きなように	좋을대로	0	//お好きなようにするといい。
かくなるうえは	이렇게 된 바에는	0
かくなる上は	이렇게 된 바에는	0
かしこまりましてございました	잘 알았습니다	0
かしこまりましてございます	잘 알겠습니다	0
かたじけのうござる	황송합니다	0
かまいなしに	상관치 않고	0
かまいもせず	상관도 하지 않고	0	//そんな俺にかまいもせずに
かまいもせずに	상관도 하지 않고	0
かまいもなしに	상관도 않고	0
かんがみるに	비추어 보건데	0
かんがみるには	비추어 보려면	0
こういうなら	이렇다면	0
ここぞとばかり	이때라는 듯이	0
ここですね	여기군요	0
ここらへんに	이 근처에	0
ここら辺に	이 근처에	0
この先に	이 앞에	0
この歳で	이 나이에	0
これまで	이것까지	0	//おそらくこれまでだ。
こんなだけど	이런 것이지만	0
こんなために	이 때문에	0
こんなのが	이런 것이	0	//こんなのがイイなんて、
こんなのに	이런 것에	0
こんなのも	이런 것도	0
こんなのを	이런 것을	0
ご機嫌斜め	심기 불편함	0
さもありなん	그럴 것이다	0	//彼なら然も有りなんだ
さもありなんだ	그럴 것이다	0	//彼なら然も有りなんだ
さも有りなん	그럴 것이다	0	//彼なら然も有りなんだ
さも有りなんだ	그럴 것이다	0	//彼なら然も有りなんだ
しかしだな	하지만 말이지	0
したりとばかり	잘 됐다는 듯	0	//鳥羽院はしたりとばかり笑う
してようがしていないだろうが	하고 있든 하고 있지 않든	0
しれっとした	천연덕스러운	0	//しれっとした顔
スキアリ	빈틈 있음	0
スキアリッ	빈틈 있음	0
すこしばかり	아주 조금만	0
そういうなら	그렇다면	0
そうたいした	그렇게 대단한	0	//そうたいしたことじゃないだろ。
そうだったな	그랬구나	0	//そ、そうだったな。
そうであるような	그럴 것 같은	0
そうなんだわ	그래요	0
そこですね	거기군요	0
そこはかとない	왠지 모를	0	//そこはかとない不安を感じながらも
そこはかとなく	공연스레	0
そのあまりにも	그 너무도	0	//そのあまりにも意外な中身
そのいずれ	그 어느쪽	0
そのために	그 때문에	0
そのためには	그걸 위해서는	0
そのまえに	그 전에	0
そのまさかよ	그 설마야	0
そのわりには	그런 것 치고는	0
それでいて	그러면서	0
それでいながら	그러면서	0
それですね	그것이군요	0
それでなかったら	그것이 아니라면	0
それでなくても	그렇지 않아도	0
それならそうと	그럼 그렇다고	0
それならそれで	그렇다면 그걸로	0
それにしては	그런 것 치고는	0
それについては	그것에 대해서는	0
それはそれで	그건 그걸로	0
それはそれとして	그건 그걸로하고	0
それはそれは	이거 정말	0	//ご幼少のリシア様は、それはそれは可愛らしゅうございました
それはでも	그건 그렇지만	0
そんなだけど	그런 것이지만	0
そんなために	그 때문에	0
そんな感じ、	그런 느낌,	0
ただいまより	지금보다	0
だめだわ	안 되요	0
ついうっかり	무심결에	0
//ついでだから	하는 김이니까	0
できることとできないこと	할 수 있는 것과 할 수 없는 것	1
どいつもコイツ梦彼も	이놈도 저놈도	0	//♞どいつもこいつも
どうしたのかね	무슨 일인걸까요	0	//ど、どうしたのかね
どうしてもこうしても	이렇게도 저렇게도	0
どうでしょうね	어떨까요	0
どうとっても	어떻게 봐도	0	//女性には、どこをどうとっても可愛さがあるのだから
どうなのだと	어떻다고	0
どうなんだと	어떻다고	0
どうもこうも	이렇지도 저렇지도	0
どうもこーも	이렇지도 저렇지도	0	//♞
どこかしらで	어딘가에서	0
どこもかしこも	여기도 저기도	0
ところかまわず	어디든 가리지 않고	0
どんなにか	얼마나	0
なにからなにまで	무엇부터 무엇까지	0	//すみません、なにからなにまで、すっかりお世話に　なってしまって
なにもかも	이것도 저것도	0
なんてこった	무슨 일이다	0
なんてったって	뭐라고 해도	0
なんとでも	뭐라고라도	0
なんにしても	어쨌든	0
なんべんとなく	몇 번씩이나	0	//なんべんとなく 往復した
なんやかんや	이러니 저러니	0
のっけから	처음부터	0
バレバレ	들키고 들키고	1
ふってわいた	느닷없이 솟아나온	0
へったくれ	뭣	0	//配慮もへったくれも
ほどなくして	얼마 지나지 않아	0
まぎれもなく	틀림없이	0	//まぎれもなく、ゆき姉の声だった。
まぎれも無く	틀림없이	0	//まぎれもなく、ゆき姉の声だった。
めっそうもございません	터무니없습니다	0
もういっかい	다시 한 번	0
もう一段階	더 한 단계	0
ゆっくりとした	느긋한	0
よりにもよって	하필이면	0
寄りにも寄って	하필이면	0
わずかずつ	조금씩	0
わずかばかり	아주 조금만	0
//稼ぐに	돈벌이에	0
減るもんじゃないし	닳는 것도 아니고	0
減るもんじゃなし	닳는 것도 아니고	0
強から弱へ	강에서 약으로	0
強から中へ	강에서 중으로	0
降ってわいた	느닷없이 솟아나온	0
降って湧いた	느닷없이 솟아나온	0
開口一番	입을 열자마자	0
見ざる聞かざる	묻지도 따지지도 않는	0
見下げ果てた	경멸스러운	0
謙遜なさる必要	겸손하실 필요	0
固いこといいっこなし	딱딱한 이야기 하지 않음	0
高い高いを	높이높이를	0
矯めつすがめつ	이모저모	0
矯めつ眇めつ	이모저모	0
僅かずつ	조금씩	0
僅かながら	얼마 안 되지만	0
僅かばかり	아주 조금만	0
機嫌ななめ	심기 불편함	0
能力の限り	능력이 닿는 한	0
能力の限りに	능력이 닿는 한	0
当然のごとく	당연하다는 듯이	0
当然のごとくに	당연하다는 듯이	0
待てど暮らせど	아무리 기다려도	0
大なり小なり	크든 작든	0
同じのを	같은 것을	0
頭かくして	머리 숨기고	0
頭が割れるほど	머리가 쪼개질 정도	1
良くも悪くも	좋아도 싫어도	0
連れ立って行けば	같이 가면	0	//連れ立って行けば
滅相もございません	터무니없습니다	0
毛頭ございません	털끝만큼도 없습니다	0
無くにしもあらず	전혀 없는 것도 아니다	0	//♞無きにしもあらず
無くにしも非ず	전혀 없는 것도 아니다	0	//♞無きにしも非ず
物足りず	충분치 않고	0
物足りずに	충분치 않고	0
弥が上にも	더욱 더	0
背に腹は	등이 배는	0
背に腹を	등이 배를	0
百聞は一見にしかず	백문이 불여일견	0
否が上にも	좋든 싫든	0
否が応でも	좋든 싫든	0
不覚にも	무의식중에	0
思う壺	예상하는 바	0
斯くなるうえは	이렇게 된 바에는	0
斯くなる上は	이렇게 된 바에는	0
私じゃなくて	내가 아니고	0	//あたしじゃなくて彼だ。**お前じゃなくて彼だ。
私じゃなくても	내가 아니라도	0
私としたことが	이 내가	0
私ばっかり	나 혼자만	1
三日にあげず	매일같이	0
上げたり下げたり	치켜올렸다가 깎아내렸다가	0
選り取り見取り	마음대로 골라잡기	1
少しばかり	아주 조금만	0
所嫌わず	어디든 가리지 않고	0
誰か人が	누군가 사람이	0
是か非か	옳은지 그른지	0
是が非でも	반드시	0
是が非にでも	반드시	0
信じようが信じまいが	믿든 믿지 않든	0
身よりを	친척을	0	//オレは子供の頃に身よりを失い、
心の持ちよう	마음가짐	0
案じ召されるな	염려 마시길	0
弱から強へ	약에서 강으로	0
弱から中へ	약에서 중으로	0
若しかしたら	어쩌면	0
言うに事欠いて	할 말이 따로있지	0
さもありそうな	그럴 법한	0
然も有らん	그럴만도 하다	0
さもあらん	그럴만도 하다	0
然もありなん	그럴만도 하다	0	//彼なら然も有りなんだ
然もありなんだ	그럴만도 하다	0	//彼なら然も有りなんだ
然も有りなん	그럴만도 하다	0	//彼なら然も有りなんだ
然も有りなんだ	그럴만도 하다	0	//彼なら然も有りなんだ
然らなければ	그렇지 않으면	0	//然らずば (예비1에서 然らなければ로 바뀜)
然様でございました	그러했습니다	0
然様でございます	그렇습니다	0
迎えに来い	맞이하러 와	0
偽らざる	속임없는	0
已むにやまれず	어찌할 수 없이	0	//(やむにやまれず)
已むに已まれず	어찌할 수 없이	0	//(やむにやまれず)
やむにやまれず	어찌할 수 없이	0
やむをえず	할 수 없이	0	//やむをえず、音美は仔猫がいる枝の先の方へと移動しはじめた。의 앞에와 이동人を呪わば穴二つ	남을 저주하면 구덩이 2개	0
やむ無し	어쩔 수 없음	0
やむなき	어쩔 수 없는	0	//やむなき理由。
止むを得ず	어쩔 수 없이	0
一癖も二癖も	한 성깔도 두 성깔도	0
入って来い	들어와	0
子供じみた	아이 같은	0
自分のことのように	자신의 일처럼	0
前見て	앞을 보고	0
蝶よ花よと	금지옥엽	0
程なくして	얼마 지나지 않아	0
精も根も	정력도 근성도	0
早い所	빨리	0
早速だが	갑작스럽지만	0
中から強へ	중에서 강으로	0
中から弱へ	중에서 약으로	0
持ってだけ	가지고만	0
千里のネタも一歩から	천리길도 한걸음부터	0
草々を	수풀을	0
出来うる限	할 수 있는 한	0
出来得る限	할 수 있는 한	0
致し方ございません	어쩔 수 없습니다	0
他ならず	다름 아니고	0	//クリミア半島のロシア編入は侵略に他ならず、いかなる正当性もない。
痛みゆえの	아프기 때문의	0
平たくいえば	쉽게 말하면	0
平たく言えば	쉽게 말하면	0
何たって	뭐라해도	0
何たっても	뭐라해도	0	//何たっても俺たちは根無し草だからな
何てったって	뭐라고 해도	0
何もかも	이것도 저것도	0
何を差し置いても	만사 제쳐두더라도	0
何層にも	몇겹이나	0
何遍となく	몇 번씩이나	0	//なんべんとなく 往復した
幸い事もあろうに	하필이면	0
嘘おっしゃい	거짓말 하지 말아요	0
好きってだけ	좋아한다는 뿐	0
好きなように	좋을대로	0	//お好きなようにするといい。
お好きな様に	좋으실대로	0
好きな様に	좋을대로	0
好むと好まざるとに	좋아하든 좋아하지 않든지	0
それではまた	그럼 또	0
蜘蛛の子を散らすように	새끼 거미가 흩어지듯이	0
蜘蛛の子を散らすような	새끼 거미가 흩어지듯한	0
蜘蛛の子を散らすよう	새끼 거미가 흩어지듯	0
いいですわね	좋네요	0
どっこいしょ	으랏차	0
ぴんぽーん	띵-동	0
コトワル	거절한다	0
やるかやんないか	할까 말까	0	//うちの学校って、部活やるかやんないか自由だから
どんな手を使っても	무슨 수를 써서라도	0
未見の	보지 못한	0	//未見の俺にも直ぐにそれだと判った。
向かう先に	향하는 앞에	0	//向かう先には。
理にも至れない身	이치도 깨우치지 못한 몸	1	//신체부위 :
面白半分に	반쯤 재미로	0	//誰かが面白半分に開けたらどうする
おもしろ半分に	반쯤 재미로	0
行動ありきと宣伝ありき	행동이 있어야 선전이 있다	0	//
穿った見方	핵심을 찌르는 견해	1
するので精一杯	하는 것으로 힘껏	1	//対処するので精一杯だ
どこかしらに	어디일까에	0	//どこかしらには。
上手くいったら	잘하면	0	//上手くいったら英雄で、最悪は廃人。
ふたりとも	두사람 모두	0	//ふたりとも家にいるはずだった。
あれほどまで	저 정도까지	0
あげようんだから	주자는 것이니까	0	//いってあげようんだからね
いたらいたで	있으면 있는걸로	0	//彼女がいなければいないで寂しいのに、いたらいたで煩わしく思えるのは何故なのですか
いち、に、さん、よん	하나, 둘, 셋, 넷	1
いち、に、さん	하나, 둘, 셋	1
位置について	자리에 위치해	0
お前にゃ	너에게는	0	//お前にゃ、まだ早い！
完膚なきまで	멀쩡한 곳이 없도록까지	0	//コレクションを完膚なきまでに消されてしまった
見ようによっては	보기에 따라서는	0
ご存知のとおり	아시는대로	0
ときめきの	두근거림의	0	//あの子を見た時に感じたときめきの正体を知りたい。
私どものように	우리들 같이	0
私どものような	우리들 같은	0
ああやって	저렇게 해	0	//先輩とああやって遊んでるのが楽しかったんだなって……
ああなって	저렇게 되어	0
肉を切らせて骨を断つ	살을 주고 뼈를 취한다	0
落ちつきを	안정을	0
出会い頭に	만나자마자	0	//出会い頭に抱きしめる。
出会い頭の	만나자마자의	0
あついから	더우니까	0	//あついからプール行こうぜ
あってなきがごとし	없는 것이나 마찬가지	0	//あってなきがごとしですよ
昔のことすぎて	너무 옛 일이라	0	//もう、昔のことすぎて覚えてない。
手元が狂って	손이 빗나가	0	//手元が狂ってそのまま胸を掴んでしまう。
我が物顔で	자기 것인양	0
我が物顔に	자기 것인양	0	//我が物顔にふるまう
あとからあとから	연달아서	0
後から後から	연달아서	0
煮るなり焼くなり	구워먹든 삶아먹든	0
清き流れに魚棲まず	맑은 물에는 고기가 살지 못한다	0
万事休す	만사 끝나버림	1	//万事休すか
男女七歳にしてお席を同じうせず	남녀칠세부동석	0	//♞
善は急げ	좋은 일은 서두른다	0	//じゃあ、善は急げってことで私達そろそろ出發するわ。
王様の耳はロバの耳	임금님 귀는 당나귀 귀	1
ふんだりけったり	엎친데 덮친격	1
なんぴとたりとも	몇 사람이라도	1
高みの見物	강 건너 불구경	1
金の切れ目が縁の切れ目	돈이 떨어지면 인연도 끊어짐	1
急がば回れ	급할수록 돌아가라	0
お茶の子さいさい	누워서 떡먹기	0
どっちかから	어디인가부터	0	//せめてどっちかから順番にしゃべれよ！
その前で	그 앞에서	0
やり合った方	서로 하는 편	1	//当事者同士がやり合った方が上手くいくよな。
行きと違って	갈 때와 달리	0
行きとは違って	갈 때와는 달리	0
行きと違う	갈 때와 다른	0
行きとは違う	갈 때와는 다른	0
その歳で	그 나이에	0	//その歳であんなもの見て
再び眠りに	다시 잠에	0	//小路は再び眠りに落ちる。
あったかくて	따듯하고	0	//あったかくて柔らかくて……そんですごくいい匂い！
身近な	가까운	0
身近で	가까이에서	0
知るよしも	알 길도	0	//その時の俺は、知るよしもなかったのである。
ばなれした	익숙해진	0	//しかし、凛とした佇まいからは、どこか日本人ばなれしたものを感じる。
取り得のない	장점이 없는	0
これといって取り得のない	이렇다 할 장점이 없는	0
藪から棒	아닌 밤중에 홍두깨	1
あまり悩ませず	너무 고민하지 않고	0
あまり悩ませずに	너무 고민하지 않고	0
あとさっきの	그리고 조금 전의	0	//あとさっきの話だけどな
向かいがてら	향하는 김에	0	//さっきは向かいがてら説明するって言ってなかったか？
ごきげんな様子	기분 좋은 모습	1
まかして置いて	맡겨 둬	0	//♞まかしといて！
絢爛なる	현란한	0	//絢爛なる円舞曲を踊ることができるだろうと。
たくらみも	계획도	0	//お前のたくらみもここまでだ。
先陣切って	앞장서	0	//先陣切って華々しく死ねってのかい？
壁に耳あり障子に目あり	벽엔 귀가 있고 문엔 눈이 있다	0
めでたしめでたし	경사로다 경사로다	0
一応の	일단의	1
顧問たって	고문해도	0
突き当りまで	막다른 곳까지	0	//突き当りまで来ると、
その名に	그 이름에	0	//その名に恥じぬ宝を持っておる
顔せんでも	얼굴 하지 않아도	0	//そんなに悲しい顔せんでも
表情せんでも	표정 하지 않아도	0
持ちなよ	가져요	0	//自身を持ちなよ
偶然による	우연에 의한	0	//単なる偶然による不運もやけに多い
関東勢百万と候え	관동에 백만 무사가 있다하나	0	//関東勢百万と候え、男はひとりもなく候
男はひとりもなく候	사내는 하나도 없구나	0	//関東勢百万と候え、男はひとりもなく候
何時も通り	언제나처럼	0
//こんな感じで	이런 느낌으로	0	//こんな感じです
ものがものだけに	물건이 물건인만큼	0
二言目には	말을 꺼냈다 하면	0	//どいつもこいつも二言目には人を暇呼ばわりしやがって。
お前がいーなら	너가 좋다면	0	//まぁーお前がいーならそれでいーけどな
口先だけ	말로만	0	//どうせ口先だけだろ？
ふりだしに	출발점에	0	//ふりだしに戻る
揃いも揃って	모두가 다	0	//揃いも揃っておおらかなのか？
そろいもそろって	모두가 다	0	//揃いも揃っておおらかなのか？
良薬口に苦し	좋은 약 입에 쓰다	0
おそらくですけど	아마도입니다만	0
唯一つの	유일의	0
虎穴にいらずんば	호랑이 굴에 들어가지 않으면	0
どれ程	어느 정도	0	//どれ程体を鍛えようと、
起き抜け	일어나자마자	1
起き抜けに	일어나자마자	0
仇なす	적대하는	0	//マスターに仇なす者は全て……。
仇なすとは	적대한다고는	0	//朝廷に仇なすとは思えません。
油断は大敵	방심은 금물	1	//まだ油断は大敵だよ
死せる	죽은	0	//死せる戦士の館ヴァルハラに勇者達の魂を集める…。
素知らない	모르는체 하는	0	//♞素知らぬ
わずかも	조금도	0	//力任せに叩きつけられる腰はわずかも速度を緩めない。
我知らず	자기도 모르게	0
わずかながら	조금이지만	0	//小路の声のトーンにわずかながら快感の色が混じってきた。
それしきの	그까짓	0	//それしきのことで引き下がったりはしません！
これしきの	이까짓	0	//
あること無いこと	있는 일 없는 일	1
あることないこと	있는 일 없는 일	1
有ること無いこと	있는 일 없는 일	1
組んず解れつ	엎치락 뒤치락	1
将又	혹은	0
はたまた	혹은	0
はるか昔の	아득한 옛날의	0
はるか昔から	아득한 옛날부터	0
しからずんば	그렇지 않으면	0
ありきなくらい	있었기에 라고 할 정도	1	//この方ありきなくらいお世話になってるママ友さんと。失敗ありきなくらいの気持ちで作ればいいんじゃないかなぁっと。
少しだけど	조금이지만	0	//少しだけど口が動いてるよ！？
あるのだか無いのだが	있는 것인가 없는 것인가	0
おいわいの	축하의	0	//『おいわいの日』
それからでも	그로부터라도	0	//話はそれからでも遅くないでしょ。
ひとことふたこと	한 마디 두 마디	0
でこぴん	딱밤	1	//でこぴんすることないだろ！
年がら年中	1년 내내	1	//毎日毎日、年がら年中、
おつかいを	심부름을	0	//おつかいを頼まれたんです
どういうのが	어떠한 것이	0	//ウィルってどういうのが目標なの？
どういうのも	어떠한 것도	0
どういうのを	어떠한 것을	0
我ながら	나로서도	0
我ながらも	나로서도	0
いたれりつくせり	극진함	1
いたれり尽くせり	극진함	1
いたれりつくせりの	극진한	0
いたれり尽くせりの	극진한	0
ひと癖もふた癖も	한 성깔도 두 성깔도	0
いちいち口に	하나 하나 입에	0	//いちいち口に出さなくてもいいだろ！？
兎にも角にも	어찌 되었든	0
おんぶにだっこ	업어주면 안아달라고 한다	1
負んぶに抱っこ	업어주면 안아달라고 한다	1
おんぶすればだっこ	업어주면 안아달라고 한다	1
負んぶすれば抱っこ	업어주면 안아달라고 한다	1
為り立ての	갓 되어 얼마 안 된	0	//中学生に為り立てのころ
善かれと	잘 되라고	0	//善かれと思ってしたことさ。善かれと祈る。
数知れず	헤아릴 수 없고	0
夜っぴて	밤새	0	//夜っぴて起きてたんならともかく。
どれもこれも	이것도 저것도	0	//どれもこれも……思い出せない。
くったくの無い	근심 없는	0	//少年はくったくの無い笑顔を見せる。
くったくのない	근심 없는	0	//少年はくったくの無い笑顔を見せる。
つり革を	손잡이를	0	//苛立ちを堪えるようにつり革を握り直すハヤト。
水をくみに	물을 길러	0	//おっちゃんは水をくみに行く。
元も子も	본전도 이자도	0	//元も子もない。
目を移らせずには	눈을 옮기지 않고는	0
目を移らせず	눈을 옮기지 못하고	0
寸でで	한끗 차이로	0
沿ぐわず	따르지 않고	0	//意に沿ぐわず秩序を乱す者は
如何にして	어떻게 해서	0
寸分足らずで	순식간에	0
いつもみたいに	언제나와 같이	0	//いつもみたいに皮肉で返す。
故に我有り	고로 나는 존재한다	0	//我思う、故に我有り
売り言葉に買い言葉	가는 말 고와야 오는 말도 곱다	0
王侯将相いずくんぞ種あらんや	왕후장상의 씨가 따로 있겠는가	0
随意に	뜻대로	0
働かざる者、食うべからず	일하지 않는 자, 먹지도 말라	0
手を変え品を変え	온갖 수단을 동원해	0
手を変え品を変えて	온갖 수단을 동원해	0
手を変え品を変えながら	온갖 수단을 동원하면서	0
窮鼠猫を噛む	궁지에 몰린 쥐 고양이를 문다	0
何処かしらに	어디인가에	0	//何処かしらにエラーが出る‥
久しぶりなまともな	오랜만의 착실한	0
感触がしたと同時	감촉이 든 것과 동시	1
見ざる言わざる聞かざる	보지도 말하지도 듣지도 않는다	0
言わざる聞かざる	말하지도 듣지도 않는다	0
百見は一聞にしかず	백문이 불여일견이다	0
私の分の	내 몫의	0	//私の分の魚も少しあげますね
物言えば唇寒し秋の風	말하자면 입은 재앙의 근원	1
焼け石に水	언 발에 오줌누기	1
知ってか知らずか	아는지 모르는지	0
過ぎたるは及ばざるが如し	지나친 것은 모자란 것과 같다	0
取らない狸の皮算用	잡지도 않은 너구리 가죽값 계산	1	//♞取らぬ狸の皮算用
おとがめなし	추궁하기 없음	1
すみからすみまで	처음부터 끝까지	0
露知らず	전혀 모르고	0	//もちろん当の本人はそんなことは露知らず。
体を張ったギャグ	몸을 던진 개그	1
照覧あれ	살피소서	0	//12本ものショートストーリーを照覧あれ！
御照覧あれ	살피소서	0
そんでもって	그러고서	0
それでもって	그러고서	0
言わずと知れた	말할 것도 없는	0
あーだこうだ	이렇다 저렇다	0	//♞あーだこーだ
あーだこうだと	이렇다 저렇다	0	//♞俺は表現に関してあーだこーだと悩んでいた。
有り合わで	마침 있는 것으로	0	//有り合わせ 의 오타인데 종종 나오는 모양
よっていたかって	여럿이 달려들어	0	//♞姉貴たちによってたかって電気アンマを。
寄っていたかって	여럿이 달려들어	0	//♞姉貴たちに寄ってたかって電気アンマを。
寄って集って	여럿이 달려들어	0	//♞姉貴たちによってたかって電気アンマを。
願わくば	바라건데	0
ねがわくは	바라건데	0
出しぬけに	불쑥	0
あまりにもあんまりな	너무나도 너무한	0
あまりにもあまりな	너무나도 너무한	0
あまりにあまんりな	너무나 너무한	0
あまりにあまりな	너무나 너무한	0
ふつーそんな	보통 그런	0	//ふつーそんな聞き間違いする？
ふつーこんな	보통 이런	0	//ふつーこんな値段で買えないから
街外れの	거리 변두리의	0	//街外れのコンビニへ向かうだろう。
高慢ちきの	거만한	0	//あんな高慢ちきのミニマム星人
口開けの	개시의	0	//口開けの客
何気なしに	별 생각 없이	0	//ふと何気なしに窓の外に目をやる
ああだこうだ	이렇다 저렇다	0	//それは当人不在の場でああだこうだ言い合っていてもわからないだろう。
いいんだか悪いのか	좋은건지 나쁜건지	0	//♞いいんだか悪いんだか
そう急がずとも	그렇게 서두르지 않더라도	0
暗暗のうちに	암암리에	0
三遍回ってワンと鳴いて	세 바퀴 돌고 멍하고 짖어	0
三遍回ってワン	세 바퀴 돌고 멍	0
三べん回ってワンと鳴いて	세 바퀴 돌고 멍하고 짖어	0
三べん回ってワン	세 바퀴 돌고 멍	0
嘘か真か	거짓인가 진실인가	0
にっちもさっちも	이러지도 저러지도	0
二進も三進も	이러지도 저러지도	0
なんかなんだか	뭔가 무엇인가	0
何かなんだか	뭔가 무엇인가	0
人にして人を	사람이면서 사람을	0
はばかりながら	송구스럽습니다만	0
こちらとても	이쪽으로서도	0
あったればこそ	있었으니까	0	//その仕込みがあったればこその諧謔事。
死して生あり生して死あり	죽음에 삶 있고 삶에 죽음 있다	0
死して十界生して十界	죽어서 10계 살아서 10계	0
死とは生なり生とは死なり	죽음은 삶이며 삶은 죽음이다	0
ありさえすれば	있기만 하면	0	//俺のものでありさえすれば
あろうがないだろうが	있든지 없든지	0	//こころがあろうがなかろうが、道具は道具。
定かならぬ	확실치 않은	0
曲がりなりにも	그럭저럭	0
どうにもこうにも	이렇게도 저렇게도	0
できたればこそ	가능했기 때문에야말로	0	//心持ちに余裕ができたればこそそんな思いも浮かぶのだ。
その割りに	그것치고	0
そのわりに	그것치고	0
なぜかくも	왜 이처럼	0
何故かくも	왜 이처럼	0
覚めやらぬ	가시지 않은	0
覚めやらない	가시지 않은	0	//♞覚めやらぬ
覚め遣らぬ	가시지 않은	0
覚め遣らない	가시지 않은	0	//♞覚め遣らぬ
冷め遣らぬ	가시지 않은	0
冷め遣らない	가시지 않은	0	//♞冷め遣らぬ
冷めやらぬ	가시지 않은	0
冷めやらない	가시지 않은	0	//♞冷めやらぬ
ほっときゃ	냅두면	0
楽しからぬ	즐겁지 않은	0
否が応にも	좋든 싫든	0
ところがどっこい	그런데 이럴수가	0	//ところがどっこい、待っていたのは婆ちゃんとコイツ。
三十六計逃げるが勝ち	삼십육계 줄행랑이 제일	0
あんたがたどこさ	당신은 어디에	0
誰のうちにでも	누구의 안에라도	0	//誰のうちにでもある。
走りませい	달리시오	0	//「もっとキリキリ走りませい」
食べませい	드시오	0
喰いませい	먹으시오	0
お帰りませい	어서 오시오	0
帰りませい	돌아 오시오	0

//#.인사 ('감)
//▀▀▀▀▀▀▀▀▀▀▀▀▀▀▀▀▀▀▀▀▀▀▀▀▀▀▀▀▀▀▀▀▀▀▀▀▀▀▀▀▀▀▀▀▀▀▀▀▀▀▀▀▀▀▀▀▀▀▀▀▀▀▀▀▀▀▀▀▀▀▀▀▀▀▀▀▀
お大事に	건강하시기를	0
おだいじに	건강하시기를	0
御大事に	건강하시기를	0
こちそーさま	잘 먹었어요	0
こちそーさまでした	잘 먹었습니다	0
ぐっじょぶ	굳 잡	1
いってらしゃい	다녀오세요	0
おかえり下さい	돌아가세요	0
よくお越し下さいました	잘 오셨습니다	0
お気の毒様	딱하게 됐습니다	0
お気の毒様ですが	딱하게 됐습니다만	0
お待ち下さいませ	기다려 주십시오	0
少々お待ち下さいませ	잠시만 기다려 주십시오	0
ありがとうござっした	감사했습니다	0
ありがとうござっしたよ	감사했어요	0
アンディオス	아디오스	1
いっただきます	잘 먹겠습니다	0
いっただっきます	잘 먹겠습니다	0
おいしいございました	맛있었습니다	0
おはいりなさい	들어오세요	0
お見知り置き下さい	처음 뵙겠습니다	0
お待たせしました	오래 기다리셨습니다	0
お待たせでした	오래 기다리셨습니다	0
お待たせ致しました	오래 기다리셨습니다	0
お待ちどうさま	오래 기다리셨어요	0
お待ちどうさまでした	오래 기다리셨습니다	0
お待ちどうさん	오래 기다리셨죠	1
お待ちどう様	오래 기다리셨어요	0
お待ちどう様でした	오래 기다리셨습니다	0
お待ち申し上げておりました	기다리고 있었습니다	0
お待ち申し上げております	기다리고 있습니다	0
お待ち遠様でした	오래 기다리셨습니다	0
お逢いしとうございました	만나뵙고 싶었습니다	0
お逢いしとうございます	만나뵙고 싶습니다	0
お邪魔いたしました	실례했습니다	0
お邪魔いたします	실례합니다	0
お邪魔さま	실례해요	0
お入りなさい	들어오세요	0
お粗末様	변변치 못했어요	0
お粗末様でございました	변변치 못했습니다	0
お粗末さまでございました	변변치 못했습니다	0
お粗末様でした	변변치 못했습니다	0
お粗末さまでした	변변치 못했습니다	0
お粗末様です	변변치 못했습니다	0
お粗末さまです	변변치 못했습니다	0
お通り下さい	통과해 주세요	0
お疲れ様でございました	수고하셨습니다	0
お疲れ様でございます	수고하셨습니다	0
お下がりなさい	물러나세요	0
お下がり下さい	물러나 주세요	0
お会いしとうございました	만나뵙고 싶었습니다	0
お会いしとうございます	만나뵙고 싶습니다	0
お休み下さい	쉬세요	0
グッジョッブ	굿잡	1
グッドラック	굿럭	1
ごきげんうるわしゅう	평안하신지요	0
ごみんごみん	미안미안	0
ごめん下さい	실례합니다	0
ごめん下さいませ	실례합니다	0
コンニチワ	콘니치와	1
ご機嫌麗しいです	평안하십니까	0	//♞필터링전 : ご機嫌麗しゅうございます
ご機嫌麗しいですか	평안하십니까	0	//♞필터링전 : ご機嫌麗しゅうございます
ご機嫌麗しゅう	평안하신지요	0
ご愁傷様	참 안됐습니다	0	//(x)
御愁傷様	참 안됐습니다	0	//(x)
ごしゅうしょうさま	참 안됐습니다	0	//(x)
サンキュッ	땡큐	1
サンクス	땡스	1
サーンキュ	땡큐	1
ばいばーい	바이바-이	1
ばいばい	바이바이	1
また明日ね	내일 봐요	0
わりぃ	미안	0
わりいぃ	미안	0
大丈夫でございました	괜찮았습니다	0
大丈夫でございます	괜찮습니다	0
謝謝	셰셰	1
申し訳在りません	죄송합니다	0
申し訳在りませんでした	죄송했습니다	0
畏まりました	알겠습니다	0
下がりなさい	물러나세요	0
下がり下さい	물러나 주세요	0
行って参ります	다녀 오겠습니다	0
頂戴致します	받겠습니다	0
頂戴致しました	받았습니다	0
いっらしゃいませ	어서 오세요	0
めんごめんご	안미안미	0
よろしくお願いしますわね	잘 부탁 드려요	0
入っていらっしゃい	들어오세요	0	//♞入ってらっしゃい
ごめんさい	미안해요	0
おめでとうさん	축하해요	0
ありがたい幸せにございます	성은이 망극하옵니다	0	//♞ありがたき幸せにございます
ありがたい幸せに	성은이 망극하게	0	//ありがたき幸せに存じまする
どうしたしまして	천만에요	0
ツァイツェン	짜이찌엔	0
お説ごもっとも	지당하신 의견입니다	0
成る程ごもっとも	과연 지당한 말씀입니다	0
成るほどごもっとも	과연 지당한 말씀입니다	0



//#.'감동사 
//▀▀▀▀▀▀▀▀▀▀▀▀▀▀▀▀▀▀▀▀▀▀▀▀▀▀▀▀▀▀▀▀▀▀▀▀▀▀▀▀▀▀▀▀▀▀▀▀▀▀▀▀▀▀▀▀▀▀▀▀▀▀▀▀▀▀▀▀▀▀▀▀▀▀▀▀▀
あらあら	아라아라	0
いやはや	거참	0
おいたわしや	딱하다	0
おやおや	이런이런	0
おらおら	오라오라	0
こらこら	이봐이봐	0
さてさて	이것 참	0
そらそらっ	이봐이봣	0
そらっそらっ	자자	0
どれどれ	어디어디	0
うおっほん	우옷흠	0
おやまあ	이런	0
はいはーい	예예-	0
よーいどん	준비- 땅	0
わっしょい	이영차	0
ワッショイ	이영차	0
うんとこどっこい	영차 영차	0






//█████████████████████████████████████████████████████████████████████████████
// 5.체언 :
//█████████████████████████████████████████████████████████████████████████████
//호칭'명사
授けし者	하사하는 자#N	1	VHn	//인간
足を踏み入れし者	발을 디딘 자#N	1	VHn	//인간
手に入れし者	손에 넣은 자#N	1	VHn	//인간 デブプラスを手に入れし者。
入れし者	넣은 자#N	1	VHn	//인간
染まりし者	물든 자#N	1	VHn	//인간
解きし者	풀어낸 자#N	1	VHn	//인간
届きし者	닿은 자#N	1	VHn	//인간
仕えし者	섬기는 자#N	1	VHn	//인간
超越せし者	초월한 자#N	1	VHn	//인간
アーチャー	아쳐#N	1	VHn	//인간
アゲハチョウ	호랑나비#N	1	QAE	//곤충류
アサシン	어쌔신#N	1	VHn	//인간
アテ馬	들러리#N	1	VHn	//인간
アナル狂い	애널광#N	1	VHn	//인간
馬鹿者め	바보놈#N	1	VHn	//인간
あまえん坊	장난꾸러기#N	1	VHn	//인간
あまえんぼう	장난꾸러기#N	1	VHn	//인간
あまえんぼぅ	장난꾸러기#N	1	VHn	//인간
あまえんぼー	장난꾸러기#N	1	VHn	//인간
あまえんぼ	장난꾸러기#N	1	VHn	//인간
甘えんぼう	응석쟁이#N	1	VHn	//인간
甘えんぼぅ	응석쟁이#N	1	VHn	//인간
甘えんぼー	응석쟁이#N	1	VHn	//인간
甘えんぼ	응석쟁이#N	1	VHn	//인간
慌ん坊	덜렁이#N	1	VHn	//인간
慌んぼう	덜렁이#N	1	VHn	//인간
慌んぼぅ	덜렁이#N	1	VHn	//인간
慌んぼー	덜렁이#N	1	VHn	//인간
慌んぼ	덜렁이#N	1	VHn	//인간
あわてん坊	덜렁이#N	1	VHn	//인간
あわてんぼう	덜렁이#N	1	VHn	//인간
あわてんぼぅ	덜렁이#N	1	VHn	//인간
あわてんぼー	덜렁이#N	1	VHn	//인간
あわてんぼ	덜렁이#N	1	VHn	//인간
ヒネクレ者	삐뚤어진 사람#N	1	VHn	//인간
ヒネクレもの	삐뚤어진 사람#N	1	VHn	//인간
捻くれ者	삐뚤어진 사람#N	1	VHn	//인간
捻くれもの	삐뚤어진 사람#N	1	VHn	//인간
ひねくれ者	삐뚤어진 사람#N	1	VHn	//인간
ひねくれもの	삐뚤어진 사람#N	1	VHn	//인간
アヤカシ	요괴#N	1	VHn	//인간
アリクイ	개미핥기#N	1	QAA	//포유류
アルケミスト	알케미스트#N	1	VHn	//인간
アンデッド	언데드#N	1	VHn	//인간
アンドロイド	안드로이드#N	1	VHn	//인간
イケメン	이케맨#N	1	VHn	//인간
イジメっ子	괴롭히는 아이#N	1	VHn	//인간
いじめっ子	괴롭히는 아이#N	1	VHn	//인간
いじめっこ	괴롭히는 아이#N	1	VHn	//인간
イジメっこ	괴롭히는 아이#N	1	VHn	//인간
いぢめっこ	괴롭히는 아이#N	1	VHn	//인간
いじめられっ子	괴롭혀지는 아이#N	1	VHn	//인간
いぢめられっ子	괴롭혀지는 아이#N	1	VHn	//인간
苛められっこ	괴롭혀지는 아이#N	1	VHn	//인간
イモウト	여동생#N	1	VHn	//인간
インタビュアー	인터뷰어#N	1	VHn	//인간
ヴァイオリニスト	바이올리스트#N	1	VHn	//인간
ヴァンパイア	뱀파이어#N	1	VHn	//인간
ヴェアヴォルフ	웨어울프#N	1	VHn	//인간
ウッカリ者	멍청이	1	VHn	//인간
ウミネコ	괭이갈매기#N	1	VHn	//인간
ウリボウ	멧돼지#N	1	QAA	//포유류
ウルフハウンド	울프하운드#N	1	QAA	//포유류
エイリアン	에일리언#N	1	VHn	//인간
エゴイスト	에고이스트#N	1	VHn	//인간
エルフ	엘프#N	1	VHn	//인간
えろおやじ	에로아저씨#N	1	VHn	//인간
おうじさま	왕자님#N	1	VHn	//인간
オーガ	오거#N	1	VHn	//인간
オカマ	여장남자#N	1	VHn	//인간
おじちゃん	아저씨#N	1	VHn	//인간
おしゃべり屋	수다쟁이#N	1	VHn	//인간
おじ様	아저씨#N	1	VHn	//인간
オス犬	수캐#N	1	QAA	//포유류
オタク	오타쿠#N	1	VHn	//인간
オタンコナス	멍청이#N	1	VHn	//인간
おたんちん	멍청이#N	1	VHn	//인간
オチンポ狂い	자지광#N	1	VHn	//인간
オッサン	아저씨#N	1	VHn	//인간
おっちゃん	아저씨#N	1	VHn	//인간
おっとり屋	차분한 사람#N	1	VHn	//인간
オトウト	남동생#N	1	VHn	//인간
オトメ	아가씨#N	1	VHn	//인간
オナニスト	오나니스트#N	1	VHn	//인간
オナペット	오나펫#N	1	VHn	//인간
オニババ	오니바바#N	1	VHn	//인간
オネエサン	누나#N	1	VHn	//인간
おねぼう	잠꾸러기#N	1	VHn	//인간
おばかさん	바보씨#N	1	VHn	//인간
おばさま	아주머님#N	1	VHn	//인간
オバチャン	아줌마#N	1	VHn	//인간
オバちゃん	아줌마#N	1	VHn	//인간
おばば	할멈#N	1	VHn	//인간
オバン	아줌마#N	1	VHn	//인간
おば様	아주머님#N	1	VHn	//인간
オフクロ	어머니#N	1	VHn	//인간
おほしさま	별님#N	1	VHn	//인간
オマワリさん	순경#N	1	VHn	//인간
オヤジ	아저씨#N	1	VHn	//인간
オヤジィ	아저씨#N	1	VHn	//인간
オヤジさん	아저씨#N	1	VHn	//인간
おやっさん	아저씨#N	1	VHn	//인간
お茶目	장난꾸러기#N	1	VHn	//인간
お馬さん	말씨#N	1	QAA	//포유류
お母さん	어머니#N	1	VHn	//인간
お母ちゃん	엄마#N	1	VHn	//인간
お婿さん	신랑#N	1	VHn	//인간
お爺さま	할아버님#N	1	VHn	//인간
お爺ちゃん	할아버지#N	1	VHn	//인간
お爺様	할아버님#N	1	VHn	//인간
お月さま	달님#N	1	VHn	//인간
お月様	달님#N	1	VHn	//인간
お偉いさん	높으신 분#N	1	VHn	//인간
お二人さん	두 사람#N	1	VHn	//인간
お二人様	두 분#N	1	VHn	//인간
お日さま	햇님#N	1	VHn	//인간
お日様	햇님#N	1	VHn	//인간
お子さま	꼬마님#N	1	VHn	//인간
お姉さま	누님#N	1	VHn	//인간
お姉さん	누나#N	1	VHn	//인간
お姉ちゃん	누나#N	1	VHn	//인간
お姉ちゃんっ子	누나쟁이#N	1	VHn	//인간
お姉ちゃん子	누나쟁이#N	1	VHn	//인간
お姉達	누나들#N	1	VHn	//인간
お子様	꼬마님#N	1	VHn	//인간
お姉様	누님#N	1	VHn	//인간
お店屋さん	가게씨#N	1	VHn	//인간
お婆様	할머님#N	1	VHn	//인간
お兄さま	오라버니#N	1	VHn	//인간
お兄さん	오빠#N	1	VHn	//인간
お兄ちゃん	오빠#N	1	VHn	//인간
お兄ちゃんっ子	오빠쟁이#N	1	VHn	//인간
お兄ちゃん子	오빠쟁이#N	1	VHn	//인간
ガイコクジン	외국인#N	1	VHn	//인간
カイロプラクティッカー	카이로프래티커#N	1	VHn	//인간
ががんぼ	꾸정모기#N	1	QAE	//곤충류
ガキンチョ	초딩#N	1	VHn	//인간
カタブツ	고지식한 사람#N	1	VHn	//인간
カメレオン	카멜레온#N	1	QAD	//파충류,양서류
カモノハシ	오리너구리#N	1	QAA	//포유류
かわい子	귀여운 아이#N	1	VHn	//인간
キツネ	여우#N	1	QAA	//포유류
キマイラ	키메라#N	1	QAA	//포유류
キモオタ	키모오타#N	1	VHn	//인간
キモブタ	오크돼지#N	1	VHn	//인간
キャッチャー	캐쳐#N	1	VHn	//인간
きれいどころ	기생#N	1	VHn	//인간
クソアマ	젠장할년#N	1	VHn	//인간
クソガキ	망할 녀석#N	1	VHn	//인간
クソガキッ	망할 자식#N	1	VHn	//인간
クソじじ	망할 영감#N	1	VHn	//인간
クソタレ	똥싸개#N	1	VHn	//인간
くそたれ	똥싸개#N	1	VHn	//인간
クソッタレ	똥싸개#N	1	VHn	//인간
くそったれ	똥싸개#N	1	VHn	//인간
クソったれ	똥싸개#N	1	VHn	//인간
くのいち	쿠노이치#N	1	VHn	//인간
くノ一	쿠노이치#N	1	VHn	//인간
クラスメイト	클래스메이트#N	1	VHn	//인간
グルメ	미식가#N	1	VHn	//인간
ケイサツ	경찰#N	1	VHn	//인간
ケダモノ	짐승#N	1	VAm	//동물
ケチンボ	구두쇠#N	1	VHn	//인간
ケンタラウス	켄타우로스#N	1	VHn	//인간
コアラ	코알라#N	1	QAA	//포유류
コイビト	연인#N	1	VHn	//인간
ゴーレム	골렘#N	1	VHn	//인간
ゴクツブシ	밥벌레#N	1	QAE	//곤충류
ゴスロリ	고스로리#N	1	VHn	//인간
コック長	주방장#N	1	VHn	//인간
コメディアン	코메디언#N	1	VHn	//인간
コヤツ	이 녀석#N	1	VHn	//인간
コレクター	컬렉터#N	1	VHn	//인간
ゴロツキ	불한당#N	1	VHn	//인간
こわがり屋	겁쟁이#N	1	VHn	//인간
こんのやろ	이 자식#N	1	VHn	//인간
こんのやろう	이 자식#N	1	VHn	//인간
コンビ	콤비#N	1	VHn	//인간
ご近所	이웃#N	1	VHn	//인간
ご隠居	노인장#N	1	VHn	//인간
サーヴァント	서번트#N	1	VHn	//인간
サキュバス	서큐버스#N	1	VHn	//인간
ザコ	자코#N	1	VHn	//인간
サッキュバス	서큐버스#N	1	VHn	//인간
サモナー	써모너#N	1	VHn	//인간
シーモンキー	씨몽키#N	1	VHn	//인간
ジェントルメン	젠틀맨#N	1	VHn	//인간
シスコン	시스콘#N	1	VHn	//인간
シスターズ	시스터즈#N	1	VHn	//인간
シモベ	하인#N	1	VHn	//인간
シャーマン	샤먼#N	1	VHn	//인간
シャイシャイボーイ	샤이샤이보이#N	1	VHn	//인간
ジャカール	쟈칼#N	1	QAA	//포유류
スコーピオン	스콜피온#N	1	QAE	//곤충류
スナイパー	스나이퍼#N	1	VHn	//인간
センパイ	선배#N	1	VHn	//인간
センパーイ	선-배#N	1	VHn	//인간
ソウルメイト	소울메이트#N	1	VHn	//인간
ソーサラー	소서러#N	1	VHn	//인간
ダーリン	달링#N	1	VHn	//인간
だいだらぼっち	다이다라봇치#N	1	VHn	//인간
だだっ子	응석꾸러기#N	1	VHn	//인간
ダチ公	친구#N	1	VHn	//인간
ダッチワイフ	더치 와이프#N	1	VHn	//인간
たわけ者	얼간이#N	1	VHn	//인간
ダンゴムシ	공벌레#N	1	QAF	//절지동물
だんご虫	공벌레	1	QAF	//절지동물
ワラジムシ	쥐며느리	1	QAF	//절지동물
チーママ	작은 마담#N	1	VHn	//인간
チビガキ	땅꼬마#N	1	VHn	//인간
チビガキッ	땅꼬마#N	1	VHn	//인간
チビスケ	꼬맹이#N	1	VHn	//인간
チビッ子	꼬맹이#N	1	VHn	//인간
チビっ子	꼬맹이#N	1	VHn	//인간
ちびっ子	꼬맹이#N	1	VHn	//인간
ちび子	꼬맹이#N	1	VHn	//인간
チャラ男	날라리 남자#N	1	VHn	//인간
チャンピオーン	챔피온#N	1	VHn	//인간
チャンプ	챔프#N	1	VHn	//인간
チョウチョ	나비#N	1	QAE	//곤충류
ちょうちょ	나비#N	1	QAE	//곤충류
チンチクリン	땅딸보#N	1	VHn	//인간
ツクツクボウシ	쓰르라미#N	1	QAE	//곤충류
つんでれ	츤데레#N	1	VHn	//인간
ツンデレラ	츤데렐라#N	1	VHn	//인간
ティーチャー	티쳐#N	1	VHn	//인간
デーモン	데몬#N	1	VHn	//인간
テクニシャン	테크니션#N	1	VHn	//인간
デザイナ	디자이너#N	1	VHn	//인간
デザイナー	디자이너#N	1	VHn	//인간
デレスケ	호색남#N	1	VHn	//인간
でれ助	호색남#N	1	VHn	//인간
ドーベルマン	도베르만#N	1	QAA	//포유류
ドクター	닥터#N	1	VHn	//인간
どじっ子	얼빠진 아이#N	1	VHn	//인간
ドスケベ	색마#N	1	VHn	//인간
どちらさま	어느 분#N	1	VHn	//인간
どちらさん	어느 분#N	1	VHn	//인간
ドッペルゲンガー	도플갱어#N	1	VHn	//인간
ドラゴン	드래곤#N	1	QAD	//파충류,양서류
ドワーフ	드워프#N	1	VHn	//인간
ナメクジ	민달팽이#N	1	QAE	//곤충류
ニンゲン	인간#N	1	VHn	//인간
のぞき魔	엿보기 변태#N	1	VHn	//인간
ノロマ	굼벵이#N	1	QAE	//곤충류
バーサーカー	버서커#N	1	VHn	//인간
バイキン	바이킹#N	1	VHn	//인간
バカップル	바보커플#N	1	VHn	//인간
バカモノ	어리석은 것#N	1	VHn	//인간
バツイチ	이혼경험자#N	1	VHn	//인간
バボ	바보#N	1	VHn	//인간
パルチザン	파르티잔#N	1	VHn	//인간
バレリーナ	발레리나#N	1	VHn	//인간
ヒキコモリ	히키코모리#N	1	VHn	//인간
ピッチャー	피쳐#N	1	VHn	//인간
ひとり子	외동아이#N	1	VHn	//인간
ビビリ屋	수줍음쟁이#N	1	VHn	//인간
ファザコン	파더콘#N	1	VHn	//인간
フェミニスト	페미니스트#N	1	VHn	//인간
ふつつか者	못난 사람#N	1	VHn	//인간
フリーター	프리터#N	1	VHn	//인간
ブルジョア	부르주아#N	1	VHn	//인간
ブルジョワ	부르주아#N	1	VHn	//인간
ブレイブマン	브레이브맨#N	1	VHn	//인간
フレンズ	프렌즈#N	1	VHn	//인간
ヘタレ	멍청이#N	1	VHn	//인간
へたれ野郎	멍청이 자식#N	1	VHn	//인간
ベッピン	미인#N	1	VHn	//인간
へっぽこ	풋내기#N	1	VHn	//인간
ヘナチョコ	풋내기#N	1	VHn	//인간
ボクサー	복서#N	1	VHn	//인간
ボディービルダー	보디빌더#N	1	VHn	//인간
ホルスタイン	젖소#N	1	QAA	//포유류
マザコン	마더콘#N	1	VHn	//인간
マゾ	마조#N	1	VHn	//인간
マッチョ	마초#N	1	VHn	//인간
ムッツリスケベ	내색않는 호색한#N	1	VHn	//인간
メスネコ	암고양이#N	1	QAA	//포유류
メスブタ	암퇘지#N	1	QAA	//포유류
メス犬	암캐#N	1	QAA	//포유류
メス奴隷	암노예#N	1	VHn	//인간
メス豚	암퇘지#N	1	QAA	//포유류
メディック	매딕#N	1	VHn	//인간
メデゥサ	메두사#N	1	VHn	//인간
メデューサ	메두사#N	1	VHn	//인간
モルモット	모르모트#N	1	QAA	//포유류
モンキー	몽키#N	1	QAA	//포유류
モンスタ	몬스터#N	1	VHn	//인간
モンスター	몬스터#N	1	VHn	//인간
ラスボス	라스트 보스#N	1	VHn	//인간
リア充	리얼충#N	1	VHn	//인간
レイディ	레이디#N	1	VHn	//인간
ロクデナシ	밥벌레#N	1	QAE	//곤충류
ろくでなし	밥벌레#N	1	QAE	//곤충류
ロマンティスト	로맨티스트#N	1	VHn	//인간
ロリコン	로리콘#N	1	VHn	//인간
ロンリーガイ	론리 가이#N	1	VHn	//인간
苛められっ子	괴롭혀지는 아이#N	1	VHn	//인간
歌人	시인[歌人]#N	1	VHn	//인간
家人	집안사람[家人]#N	1	VHn	//인간
歌姫	가희[歌姬]#N	1	VHn	//인간
間男	샛서방#N	1	VHn	//인간
巨犬	큰 개#N	1	QAA	//포유류
検非違使	검비위사#N	1	VHn	//인간
見鬼	견귀[見鬼]#N	1	VHn	//인간
庫裏方	조리사#N	1	VHn	//인간
高慢娘	교만한 아가씨#N	1	VHn	//인간
古神	고신[古神]#N	1	VGn	//신(성인)
公家	공가[公家]#N	1	VHn	//인간
狂人	광인[狂人]#N	1	VHn	//인간
校医	교의#N	1	VHn	//인간
橋姫	하시히메#N	1	VGn	//신(성인)
蚯蚓	지렁이#N	1	QAF	//절지동물
旧人類	구인류#N	1	VHn	//인간
軍曹	군조#N	1	VHn	//인간
鬼嫁	도깨비부인#N	1	VHn	//인간
貴機	귀기[貴機]#N	1	VHn	//인간
鬼神	귀신#N	1	VHn	//인간
鬼姫	귀희[鬼姬]#N	1	VHn	//인간
鬼畜	귀축#N	1	VHn	//인간
根なし草	떠돌이#N	1	VHn	//인간
根無し草	떠돌이#N	1	VHn	//인간
近所さん	이웃씨#N	1	VHn	//인간
機械オンチ	기계치#N	1	VHn	//인간
綺麗所	기생#N	1	VHn	//인간
男魔族	남자마족#N	1	VHn	//인간
男神	남신[男神]#N	1	VGn	//신(성인)
男優	남배우#N	1	VHn	//인간
男子校生	남학생#N	1	VHn	//인간
娘っこ	아가씨#N	1	VHn	//인간	//なんべん言ってもわからん娘っこだ
娘達	아가씨들#N	1	VHn	//인간
娘御	아가씨#N	1	VHn	//인간
女騎士	여기사#N	1	VHn	//인간
女童	여동[女童]#N	1	VHn	//인간
女魔族	여마족#N	1	VHn	//인간
女王様	여왕님#N	1	VHn	//인간
女子供	아녀자#N	1	VHn	//인간
女子校生	여학생#N	1	VHn	//인간
女子生徒	여학생#N	1	VHn	//인간
女将	여주인#N	1	VHn	//인간
女戦士	여전사#N	1	VHn	//인간
女学園生	여학원생#N	1	VHn	//인간
女狐	암여우#N	1	VHn	//인간
年配の方	나이 있으신 분#N	1	VHn	//인간
年増女	노처녀#N	1	VHn	//인간
怒鬼	노귀[怒鬼]#N	1	VHn	//인간
奴隷	노예#N	1	VHn	//인간
奴婢	노비#N	1	VHn	//인간
儂等	우리들#N	1	VHn	//인간
能天使	능천사#N	1	VHn	//인간
//茶目	장난꾸러기#N	1	VHn	//인간
茶目っ子	장난꾸러기#N	1	VHn	//인간
旦那さま	서방님#N	1	VHn	//인간
旦那さん	서방님#N	1	VHn	//인간
旦那様	서방님#N	1	VHn	//인간
//旦那	서방#N	1	VHn	//인간
大貴族	대귀족#N	1	VHn	//인간
大馬鹿	왕바보#N	1	VHn	//인간
大馬鹿者	왕바보#N	1	VHn	//인간
大魔神	대마신#N	1	VGn	//신(성인)
大蚊	꾸정모기#N	1	QAE	//곤충류
大変態	대변태#N	1	VHn	//인간
大勢人	많은 사람#N	1	VHn	//인간
対手	적수#N	1	VHn	//인간
大悪魔	대악마#N	1	VHn	//인간
稲荷	곡식의 신#N	1	VGn	//신(성인)
都会っ子	도시 아이#N	1	VHn	//인간
独りっ子	외동아이#N	1	VHn	//인간
独り子	외동아이#N	1	VHn	//인간
頭領	두령#N	1	VHn	//인간
落とし主	분실자#N	1	VHn	//인간
嵐神	폭풍의 신#N	1	VGn	//신(성인)
浪人生	재수생#N	1	VHn	//인간
狼藉者	불한당#N	1	VHn	//인간
両性愛者	양성애자#N	1	VHn	//인간
連れ子	의붓자식#N	1	VHn	//인간
恋人	연인#N	1	VHn	//인간
恋姫	연희[戀姬]#N	1	VHn	//인간
老教師	노교사#N	1	VHn	//인간
老魔術師	노마술사#N	1	VHn	//인간
老王	노왕#N	1	VHn	//인간
老医師	노의사#N	1	VHn	//인간
老執事	노집사#N	1	VHn	//인간
碌でなし	밥벌레#N	1	QAE	//곤충류
碌で無し	밥벌레#N	1	QAE	//곤충류
寮監	기숙사감#N	1	VHn	//인간
寮母	기숙사감#N	1	VHn	//인간
竜騎士	용기사#N	1	VHn	//인간
龍神	용신#N	1	VHn	//인간
水龍	수룡#N	1	VHn	//인간 水龍神殿
竜王	용왕#N	1	VGn	//신(성인)
竜族	용족#N	1	QNP	//민족명
魑魅魍魎	온갖 잡귀#N	1	VHn	//인간
馬鹿め	바보놈#N	1	VHn	//인간
馬鹿者	바보녀석#N	1	VHn	//인간
魔物	마물	1	VAm	//동물
魔神	마신#N	1	VGn	//신(성인)
魔姫	마희[魔姬]#N	1	VHn	//인간
莫迦	멍청이#N	1	VHn	//인간
万人	만인#N	1	VHn	//인간
末娘	막내딸#N	1	VHn	//인간
亡き陛下	선대 폐하#N	1	VHn	//인간
忘れん坊	잘 잊는 사람#N	1	VHn	//인간
売女	창녀#N	1	VHn	//인간
妹様	여동생님#N	1	VHn	//인간
妹御	여동생분#N	1	VHn	//인간
妹的存在	여동생적 존재#N	1	VHn	//인간
猛者	용맹한 자#N	1	VHn	//인간
眠り姫	잠자는 공주#N	1	VHn	//인간
面倒くさがりや	귀찮음쟁이#N	1	VHn	//인간
面倒くさがり屋	귀찮음쟁이#N	1	VHn	//인간
面倒くさがり	귀찮음쟁이#N	1	VHn	//인간
母さま	어머님#N	1	VHn	//인간
母ちゃん	엄마#N	1	VHn	//인간
牡犬	수캐#N	1	QAA	//포유류
牡豚	수퇘지#N	1	QAA	//포유류
牡獣	수컷짐승#N	1	QAA	//포유류
木精	나무의 정령#N	1	VGn	//신(성인)
夢魔	몽마#N	1	VHn	//인간
猫舌	고양이혀#N	1	VHn	//인간
墓守	묘지기#N	1	VHn	//인간
舞い手	무용수#N	1	VHn	//인간
武骨者	얼뜨기#N	1	VHn	//인간
無骨者	얼뜨기#N	1	VHn	//인간
武者	무사#N	1	VHn	//인간
//美姫	미희[美姬]#N	1	VHn	//인간
薄羽蜻蛉	명주잠자리#N	1	QAE	//곤충류
薄情者	야박한 자#N	1	VHn	//인간
方々	여러분#N	1	VHn	//인간 **사방 이라는 뜻도 있지만...
白面金毛	백면금모#N	1	QAA	//포유류
百人隊長	백인대장#N	1	VHn	//인간
白痴者	얼간이#N	1	VHn	//인간
罰当たりめ	벌 받을 놈#N	1	VHn	//인간
罰当りめ	벌 받을 놈#N	1	VHn	//인간
法王	법왕#N	1	VHn	//인간
普通男	보통남#N	1	VHn	//인간
鳳凰	봉황#N	1	QAB	//조류
富める者	부유한 자#N	1	VHn	//인간
婦警	여경#N	1	VHn	//인간
不届き者	괘씸한 자#N	1	VHn	//인간
父娘	부녀#N	1	VHn	//인간
不埒者	발칙한 놈#N	1	VHn	//인간
浮浪人	부랑자#N	1	VHn	//인간
不良娘	불량한 아가씨#N	1	VHn	//인간
付喪神	츠쿠모가미#N	1	VGn	//신(성인)
不束者	못난 사람#N	1	VHn	//인간
不審者	수상한 자#N	1	VHn	//인간
不真面目君	불성실군#N	1	VHn	//인간
不忠者	불충자#N	1	VHn	//인간
北天神	북천신#N	1	VHn	//인간
比丘尼	비구니#N	1	VHn	//인간
卑劣漢	비열한#N	1	VHn	//인간
飛龍	비룡#N	1	QAD	//파충류,양서류
牝犬	암캐#N	1	QAA	//포유류
牝奴隷	암노예#N	1	VHn	//인간
牝豚	암퇘지#N	1	QAA	//포유류
牝獣	암컷짐승#N	1	VAm	//동물
牝牛	암소#N	1	QAA	//포유류
牝豹	암표범#N	1	QAA	//포유류
牝狐	암여우#N	1	QAA	//포유류
使い魔	사역마#N	1	VHn	//인간
使い手	사용자#N	1	VHn	//인간
捨て犬	유기견#N	1	QAA	//포유류
蛇女	사녀[蛇女]#N	1	VHn	//인간
四神	사신#N	1	VGn	//신(성인)
死神	사신#N	1	VGn	//신(성인)
私様	나님#N	1	VHn	//인간
山神	산신#N	1	VGn	//신(성인)
山人	산인[山人]#N	1	VHn	//인간
三馬鹿	세 바보#N	1	VHn	//인간 : いつの間にかそれが当たり前になって、左月や竜也たちと三バカなんて呼ばれるようになって……
上つ方	높으신 분#N	1	VHn	//인간
色魔	색마#N	1	VHn	//인간
生ける屍	살아있는 시체#N	1	VHn	//인간
甥っ子	조카#N	1	VHn	//인간
生徒会長	학생회장#N	1	VHn	//인간
婿がね	사윗감#N	1	VHn	//인간
蜥蜴	도마뱀#N	1	QAD	//파충류,양서류
先公	선공[先公]#N	1	VHn	//인간
先生様	선생님	1	VHn	//인간
先祖様	선조님#N	1	VGn	//신(성인)
屑男	쓰레기남#N	1	VHn	//인간
雪女	설녀#N	1	VHn	//인간
聖騎士	성기사#N	1	VHn	//인간
猩猩蠅	초파리#N	1	QAE	//곤충류
性獣	성수[性獸]#N	1	VAm	//동물
星様	별님#N	1	VHn	//인간
性玩具	성도구#N	1	VHn	//인간
歳神	곡식의 신#N	1	VGn	//신(성인)
笑い芸人	희극인#N	1	VHn	//인간
小鬼	작은 귀신#N	1	VHn	//인간
小僧	애송이#N	1	VHn	//인간
小悪魔	소악마#N	1	VHn	//인간
少佐	소좌#N	1	VHn	//인간
送り人	보내는 사람#N	1	VHn	//인간
受ける側	받는 측#N	1	VHn	//인간
受け手	받는편#N	1	VHn	//인간
手ごま	부하#N	1	VHn	//인간
手駒	부하#N	1	VHn	//인간
水竜	수룡#N	1	QAD	//파충류,양서류
睡魔	수마[睡魔]	1	VHn	//인간
水神	수신#N	1	VGn	//신(성인)
獣人	수인[獸人]#N	1	VHn	//인간
水精	물의 정령#N	1	VGn	//신(성인)
熟女	숙녀#N	1	VHn	//인간
宿主	숙주#N	1	VHn	//인간
術者	시술자#N	1	VHn	//인간
柴犬	시바이누#N	1	QAA	//포유류
始末屋	암살자#N	1	VHn	//인간
式神	식신#N	1	VGn	//신(성인)
神の遣い	신의 사자#N	1	VGn	//신(성인)
神様	신님#N	1	VGn	//신(성인)
新卒教員	신입교원#N	1	VHn	//인간
深き方	깊은 분#N	1	VHn	//인간
辻商人	가두상인#N	1	VHn	//인간
十人隊長	십인대장#N	1	VHn	//인간
我ら女	우리 여자#N	1	VHn	//인간
餓畜	굶주린 짐승#N	1	VAm	//동물
悪ガキ	못된 꼬마#N	1	VHn	//인간
悪霊#N	악령#N	1	VHn	//인간
悪獣	악한 짐승#N	1	VAm	//동물
悪戯っ子	장난꾸러기#N	1	VHn	//인간
愛息	애식[愛息]#N	1	VHn	//인간
愛息子	애식[愛息]#N	1	VHn	//인간
厄介者	애물단지#N	1	VHn	//인간
爺ちゃん	할아버지#N	1	VHn	//인간
野盗	도둑#N	1	VHn	//인간
爺様	할아버님	1	VHn	//인간
若嫁	젊은 신부#N	1	VHn	//인간
若旦那	큰 도련님#N	1	VHn	//인간
若旦那様	큰도련님#N	1	VHn	//인간
若奥	젊은 부인#N	1	VHn	//인간
若奥様	젊은 사모님#N	1	VHn	//인간
嬢ちゃん	아가씨#N	1	VHn	//인간
御客様	손님#N	1	VHn	//인간
御客人	손님#N	1	VHn	//인간
御頭	두령#N	1	VHn	//인간
御仁	양반#N	1	VHn	//인간
御子	천황의 자녀#N	1	VHn	//인간
言いだしっぺ	말 꺼낸 사람#N	1	VHn	//인간
言い出しっぺ	먼저 말을 시작한 사람#N	1	VHn	//인간
言い出しっ屁	먼저 말을 시작한 사람#N	1	VHn	//인간
余所者	낯선 사람#N	1	VHn	//인간
如何様師	사기꾼#N	1	VHn	//인간
軟弱者	나약자#N	1	VHn	//인간
影女	영녀[影女]#N	1	VHn	//인간
英雄様	영웅님#N	1	VHn	//인간
裔子	후손#N	1	VHn	//인간
汚っさん	아저씨#N	1	VHn	//인간
王太子	왕태자#N	1	VHn	//인간
王太子妃	왕태자비#N	1	VHn	//인간
//妖し	요괴#N	1	VHn	//인간
妖魔	요마#N	1	VHn	//인간
饒舌家	수다쟁이#N	1	VHn	//인간
妖狐	요호[妖狐]#N	1	QAA	//포유류
愚か者	어리석은 자#N	1	VHn	//인간
愚か者め	어리석은 놈#N	1	VHn	//인간
右大臣	우대신#N	1	VHn	//인간
愚物	어리석은 것#N	1	VHn	//인간
愚民	우민#N	1	VHn	//인간
愚者	어리석은 자#N	1	VHn	//인간
愚帝	어리석은 왕#N	1	VHn	//인간
優婆塞	출가하지 않은 승려#N	1	VHn	//인간
羽虫	날벌레#N	1	QAE	//곤충류
雄犬	수캐#N	1	QAA	//포유류
雄豚	수퇘지#N	1	QAA	//포유류
元気娘	기운찬 아가씨#N	1	VHn	//인간
元恋人	옛 연인#N	1	VHn	//인간
月人	월인[月人]#N	1	VHn	//인간
慰み者	노리겟감#N	1	VHn	//인간
委員長	위원장#N	1	VHn	//인간
幼女	유녀[幼女]#N	1	VHn	//인간
幼馴染み	소꿉친구#N	1	VHn	//인간
有翼生物	유익생물#N	1	VAm	//동물
幼帝	유제[幼帝]#N	1	VHn	//인간
肉嫁	고기 신부#N	1	VHn	//인간
肉奴隷	육노예#N	1	VHn	//인간
隠者	은둔자#N	1	VHn	//인간
淫魔	음마#N	1	VHn	//인간
義理の父母	의붓부모#N	1	VHn	//인간
義理の父親	의붓아버지#N	1	VHn	//인간
義理の母親	의붓어머니#N	1	VHn	//인간
義理のお姉さん	의붓누나#N	1	VHn	//인간
義理の息子	의붓아들#N	1	VHn	//인간
義妹	의매[義妹]#N	1	VHn	//인간
義母	의모#N	1	VHn	//인간
義父	의부#N	1	VHn	//인간
義姉	의누이#N	1	VHn	//인간
義姉弟	의남매#N	1	VHn	//인간
耳年増	성숙한 처녀[耳年增]#N	1	VHn	//인간
異母弟	이복동생#N	1	VHn	//인간
人間族	인간족#N	1	QNP	//민족명
人狼	인랑[人狼]#N	1	VHn	//인간
仁王	인왕[仁王]#N	1	VHn	//인간
忍王	인왕[忍王]#N	1	VHn	//인간
人族	인족[人族]#N	1	QNP	//민족명
人型	인형#N	1	VHn	//인간
一粒種	외동#N	1	VHn	//인간
一児	한 아이#N	1	VHn	//인간
一人っ子	외동아이#N	1	VHn	//인간
一人子	외동아이#N	1	VHn	//인간
一学生	한 학생#N	1	VHn	//인간
姉さま	누님#N	1	VHn	//인간
姉さん	누나#N	1	VHn	//인간
姉ちゃん	누나#N	1	VHn	//인간
仔犬	강아지#N	1	QAA	//포유류
雌犬	암캐#N	1	QAA	//포유류
子供	아이#N	1	VHn	//인간
子共	아이#N	1	VHn	//인간
仔供	자공[仔供]#N	1	VHn	//인간
雌奴隷	암노예#N	1	VHn	//인간
雌豚	암퇘지#N	1	QAA	//포유류
雌鹿	암사슴#N	1	QAA	//포유류
仔描	새끼고양이#N	1	QAA	//포유류
仔猫	새끼고양이#N	1	QAA	//포유류
自分たち	자신들#N	1	VHn	//인간
姉様	누님#N	1	VHn	//인간
雌鳥	암탉#N	1	QAB	//조류
茨姫	잠자는 공주#N	1	VHn	//인간
雌雉	암꿩#N	1	QAB	//조류
子兎	작은 토끼#N	1	QAA	//포유류
雌狐	암여우#N	1	QAA	//포유류
雑魚	송사리#N	1	QAC	//어류
姐さん	누님#N	1	VHn	//인간
狙撃主	저격수#N	1	VHn	//인간
赤騎士	붉은 기사#N	1	VHn	//인간
戦狂	전쟁광#N	1	VHn	//인간
転校生	전학생#N	1	VHn	//인간
戦鬼	전귀[戰鬼]#N	1	VHn	//인간
田舎者	촌사람#N	1	VHn	//인간
戦乙女	전처녀#N	1	VHn	//인간
戦姫	전희[戰姬]#N	1	VHn	//인간
店員	점원#N	1	VHn	//인간
正騎士	정식기사#N	1	VHn	//인간
町娘	마을아가씨#N	1	VHn	//인간
整体師	정체사#N	1	VHn	//인간
精子狂	정액광#N	1	VHn	//인간
正解者	정답자#N	1	VHn	//인간
弟妹	동생#N	1	VHn	//인간
操り人形	꼭두각시#N	1	VHn	//인간
鳥頭	새대가리#N	1	QAB	//조류
助兵衛	호색가#N	1	VHn	//인간
祖父	조부#N	1	VHn	//인간
従者	수행원#N	1	VHn	//인간
従兄	사촌형#N	1	VHn	//인간
従兄妹	사촌남매#N	1	VHn	//인간
座敷童子	좌부동자#N	1	VGn	//신(성인)
主達	주인들#N	1	VHn	//인간
仲居	하녀#N	1	VHn	//인간
中年男	중년남#N	1	VHn	//인간
重歩兵	중보병#N	1	VHn	//인간
重戦士	중전사#N	1	VHn	//인간
只者	보통사람#N	1	VHn	//인간
地精	땅의 정령#N	1	VGn	//신(성인)
織姫	직녀#N	1	VHn	//인간
真面目君	성실군#N	1	VHn	//인간
借金取り	빚쟁이#N	1	VHn	//인간
蒼龍	청룡#N	1	QAD	//파충류,양서류
采女	궁녀#N	1	VHn	//인간
天邪鬼	심술쟁이#N	1	VHn	//인간
千人隊長	천인대장#N	1	VHn	//인간
川赤子	카와아가코#N	1	VGn	//신(성인)
妾腹	첩복[妾腹]#N	1	VHn	//인간
青竜	청룡#N	1	QAD	//파충류,양서류
招き猫	복고양이#N	1	QAA	//포유류
村娘	마을 아가씨#N	1	VHn	//인간
村人女	마을여자#N	1	VHn	//인간
総司令官	총사령관#N	1	VHn	//인간
枢機卿	추기경#N	1	VHn	//인간
雛鳥	아기새#N	1	QAB	//조류
出目金	눈툭금붕어#N	1	QAC	//어류
側女	시녀#N	1	VHn	//인간
恥ずかしがり屋	부끄럼쟁이#N	1	VHn	//인간
痴女	치녀#N	1	VHn	//인간
治天の君	태상천황#N	1	VHn	//인간
親父殿	아버님#N	1	VHn	//인간
七人ミサキ	7인미사키#N	1	VGn	//신(성인)
他部族	타부족#N	1	VGt	//집합(군집)
太母	태모[太母]#N	1	VHn	//인간
太夫	타유[太夫]#N	1	VHn	//인간
駄駄っ子	응석쟁이#N	1	VHn	//인간
八咫鴉	야타가라스#N	1	VGn	//신(성인)
貝獣	패수[貝獸]#N	1	QAC	//어류
唄姫	패희[唄姬]#N	1	VHn	//인간
彼氏	남자친구#N	1	VHn	//인간
荷物持ち	짐꾼#N	1	VHn	//인간
何屋さん	뭐하는 사람#N	1	VHn	//인간
下種	천한 신분#N	1	VHn	//인간
下衆	천한 신분#N	1	VHn	//인간
学院生	학원생#N	1	VHn	//인간
行かず後家	노처녀#N	1	VHn	//인간
香天女	향천녀#N	1	VGn	//신(성인)
兄さま	오라버니#N	1	VHn	//인간
兄さん	오빠#N	1	VHn	//인간
兄ちゃん	오빠#N	1	VHn	//인간
兄貴	형님#N	1	VHn	//인간
兄様	오라버니#N	1	VHn	//인간
兄者	형님#N	1	VHn	//인간
兄者殿	형님#N	1	VHn	//인간
兄弟子	동문선배#N	1	VHn	//인간
狐狸	호리#N	1	QAA	//포유류
好青年	호청년[好靑年]#N	1	VHn	//인간
好々爺	마음좋은 할아범#N	1	VHn	//인간
好好爺	마음좋은 할아범#N	1	VHn	//인간
紅鱒	홍송어#N	1	QAC	//어류
化ケ物	괴물#N	1	VHn	//인간
火龍	화룡#N	1	QAD	//파충류,양서류
火蜥蜴	불도마뱀#N	1	QAD	//파충류,양서류
火星人	화성인#N	1	VHn	//인간
和人	일본인#N	1	VHn	//인간
丸裸	벌거숭이#N	1	VHn	//인간
荒神	아라가미[荒神]	1	VGn	//신(성인)
皇太弟	황태제#N	1	VHn	//인간
虫ケラ	버러지#N	1	QAE	//곤충류
戯け者	얼간이#N	1	VHn	//인간
雨女	우녀[雨女]#N	1	VHn	//인간
元カノ	전여친#N	1	VHn	//인간
新米教師	신입교사#N	1	VHn	//인간
内弁慶	집에서만 큰소리#N	1	VHn	//인간
//臆病	겁쟁이#N	0	VHn	//인간
介護者	간병인#N	1	VHn	//인간
ヒメアカタテハ	작은멋쟁이나비#N	1	QAE	//곤충류
ヤマガミサマ	산신님#N	1	VGn	//신(성인)
開祖	개조[開祖]#N	1	VHn	//인간
ヤマネコ	산고양이#N	1	QAA	//포유류
学園長	학원장#N	1	VHn	//인간
浪人	낭인#N	1	VHn	//인간
妹君	여동생군#N	1	VHn	//인간
姉君	누나군#N	1	VHn	//인간 : 姉君の危機を助けてはくれないか？
目付	감찰무사#N	1	VHn	//인간
亡き殿	돌아가신 분[殿]#N	1	VHn	//인간
妹達	여동생들#N	1	VHn	//인간
末の娘	막내딸#N	1	VHn	//인간
そなた	그대#N	1	VHn	//인간
トモダチ	친구#N	1	VHn	//인간
ネボスケ	잠꾸러기#N	1	VHn	//인간
マヌケ	얼간이#N	1	VHn	//인간
ゆかいはん	유괴범#N	1	VHn	//인간
俊秀	준재[俊秀]#N	1	VHn	//인간
あいっつ	저 녀석#N	1	VHn	//인간
あいじん	애인#N	1	VHn	//인간
早食い王	빨리먹기왕#N	1	VHn	//인간
拗ねキャラ	삐짐 캐릭터#N	1	VHn	//인간
情報屋	정보상#N	1	VHn	//인간 : 情報屋の手が、苦しげに俺の襟を掴んだ。
いいんちょ	위원장#N	1	VHn	//인간 : 
//いなご	메뚜기#N	1	VHn	//인간 : 
イタズラっ子	장난꾸러기#N	1	VHn	//인간 : 
イソガニ	바위게#N	1	VAm	//동물
イワガニ	바위게#N	1	VAm	//동물
ぼうや	꼬마#N	1	VHn	//인간 : 
ロマンチスト	로맨티스트#N	1	VHn	//인간 : 
従姉弟	사촌동생#N	1	VHn	//인간 : 
女兵	여자 병사#N	1	VHn	//인간 : 
トビウオ	날치#N	1	VAm	//동물
仔豚	새끼돼지#N	1	VAm	//동물
仔羊	새끼양#N	1	VAm	//동물
金食い虫	돈 먹는 벌레#N	1	VHn	//인간 : 
コンシェルジュ	콩셰르주#N	1	VHn	//인간 : 
座敷童	좌부동#N	1	VHn	//인간 : 
影武者	카케무사#N	1	VHn	//인간 : 
借り腹	씨받이#N	1	VHn	//인간 : 
成り金	벼락부자#N	1	VHn	//인간 : 
モンゴリアン	몽골리안#N	1	QNP	//민족명
穴熊	오소리#N	1	VAm	//동물
賞金首	현상범#N	1	VHn	//인간 : 
おじさま	아저씨#N	1	VHn	//인간 : 
実姉	친누나#N	1	VHn	//인간 : 
虎魚	쑤기미[虎魚]#N	1	VAm	//동물
誰彼	이 사람 저 사람#N	1	VHn	//인간 : なにしろ誰彼かまわず声を掛けてるのはみんな知ってますし
一人ぼっち	외톨이#N	1	VHn	//인간 : 
アンモナイト	암모나이트#N	1	VAm	//동물
ピラニア	피라니아#N	1	VAm	//동물
姫君	아가씨#N	1	VHn	//인간 : 
アフガンハウンド	아프간 하운드#N	1	VAm	//동물
柳葉魚	열빙어#N	1	VAm	//동물
のら猫	길고양이#N	1	VAm	//동물
ひよっこ	애송이#N	1	VHn	//인간 : 
ヒヨッコ	애송이#N	1	VHn	//인간 : 
大食家	대식가#N	1	VHn	//인간 : 
//お嬢さん	아가씨#N	1	VHn	//인간 : 
ど変態	변태#N	1	VHn	//인간 : **そのほど変態。このど変態。
イタズラ子	장난꾸러기#N	1	VHn	//인간 : 
おてつだいさん	가정부#N	1	VHn	//인간 : 
ごしゅじん	주인#N	1	VHn	//인간 : ごしゅじんさま
おばぁさん	아줌마#N	1	VHn	//인간 : 
おばーさん	아줌마#N	1	VHn	//인간 : 
だんな様	서방님#N	1	VHn	//인간 : 
おこっちゃま	꼬마님#N	1	VHn	//인간 : 
おこちゃま	꼬마님#N	1	VHn	//인간 : 
お人よし	호인#N	1	VHn	//인간 : 
お好よし	호인#N	1	VHn	//인간 : 
寝ぼすけ	잠꾸러기#N	1	VHn	//인간 : 
能転気	덜렁이#N	1	VHn	//인간 : 
脳天気	덜렁이#N	1	VHn	//인간 : 
後添い	후처#N	1	VHn	//인간 : 後添えの連れ子でも他人だ。後添えの連れ子ではだめか。
後添え	후처#N	1	VHn	//인간 : 
忘れんぼう	잘 잊는 사람#N	1	VHn	//인간 : 忘れんぼうさん
忘れんぼ	잘 잊는 사람#N	1	VHn	//인간 : 忘れんぼ
仲間達	동료들#N	1	VHn	//인간 : 仲間達に直接お願いする。
おいらたち	우리들#N	1	VHn	//인간 : 
お婆ちゃん	할머니#N	1	VHn	//인간 : 
たったひとり	단 한사람#N	1	VHn	//인간 : たったひとりの戦士
初カノ	첫그녀#N	1	VHn	//인간 : 
イタズラッ子	장난꾸러기#N	1	VHn	//인간 : 
地上げ屋	땅투기꾼#N	1	VHn	//인간 : 
トーヘンボク	벽창호#N	1	VHn	//인간 : 
負うた子	업은 아이#N	1	VHn	//인간 : 負うた子に教わる
夢想家	몽상가#N	1	VHn	//인간 : 
ボンクラ	멍청이#N	1	VHn	//인간 : 
ぼんくら	멍청이#N	1	VHn	//인간 : このボンクラと何があったんだ！？
エライヒト	대단한 사람#N	1	VHn	//인간 : 
おりこうさん	똘똘이씨#N	1	VHn	//인간 : 課金アイテムで出たら一番売れそうなのはおりこうさん羅針盤
腹黒女	뱃속 검은 여자#N	1	VHn	//인간 : 
腹黒男	뱃속 검은 남자#N	1	VHn	//인간 : 
女たらし	난봉꾼[女たらし]#N	1	VHn	//인간 : ただの女たらしより聞き捨てならない。
女ったらし	난봉꾼[女ったらし]#N	1	VHn	//인간 : ただの女たらしより聞き捨てならない。
男たらし	난봉녀[男たらし]#N	1	VHn	//인간 : 
男ったらし	난봉녀[男ったらし]#N	1	VHn	//인간 : 
頑張り屋	노력파#N	1	VHn	//인간 :
虎児	새끼 호랑이#N	1	VAm	//동물
空を飛ぶ鳥	하늘을 나는 새#N	1	VAm	//동물
荒鷲	용맹한 독수리#N	1	VAm	//동물
愛娘	사랑스런 딸#N	1	VHn	//인간 :
がきんちょ	꼬맹이#N	1	VHn	//인간 :
贋者	가짜#N	1	VHn	//인간 :
腑抜け	겁쟁이#N	1	VHn	//인간 :
ドザエモン	익사자#N	1	VHn	//인간 :
ゴールデンレトリバー	골든 리트리버#N	1	VAm	//동물
彼氏彼女	그와 그녀#N	1	VHn	//인간 :
コスプレイヤー	코스플레이어#N	1	VHn	//인간 :
ぽっと出	풋내기#N	1	VHn	//인간 :
来訪者	내방자#N	1	VHn	//인간 :
料理長	요리장#N	1	VHn	//인간 :
ばけもの	괴물#N	1	VHn	//인간 :
名たんてい	명탐정#N	1	VHn	//인간 :
ひとさらい	유괴범#N	1	VHn	//인간 :
女主人	여주인#N	1	VHn	//인간 : 女主人と召使いごっこしたり。
たびびと	여행자#N	1	VHn	//인간 :
下級生	하급생#N	1	VHn	//인간 : 下級生の子
馬鹿もん	바보#N	1	VHn	//인간 : 
馬鹿モン	바보#N	1	VHn	//인간 : 
でくの坊	멍청이#N	1	VHn	//인간 : 
只人	보통 사람#N	1	VHn	//인간 : 
面食い	얼굴 밝하는 사람#N	1	VHn	//인간 : 
面喰い	얼굴 밝하는 사람#N	1	VHn	//인간 : 
犬っころ	강아지#N	1	VAm	//동물
死霊	사령[死靈]#N	1	VHn	//인간 : 
九尾の狐	구미호#N	1	VAm	//동물
九尾のきつね	구미호#N	1	VAm	//동물
九尾のキツネ	구미호#N	1	VAm	//동물
小夜啼鳥	밤꾀꼬리#N	1	VAm	//동물
引く手	권유하는 사람#N	1	VHn	//인간 : 
オオクワガタ	왕사슴벌레#N	1	VAm	//동물
カラスアゲハ	제비나비#N	1	VAm	//동물
夢見師	몽견사#N	1	VHn	//인간 : 
小坊主	꼬마#N	1	VHn	//인간 : 
さらし者	죄인#N	1	VHn	//인간 : 
子泣き爺	코나키지지#N	1	VHn	//인간 : 요괴이름
野良猫	길고양이#N	1	VAm	//동물
のらねこ	길고양이#N	1	VAm	//동물
手足れ	달인#N	1	VHn	//인간 : 
手練れ	달인#N	1	VHn	//인간 : 
ハツカネズミ	생쥐#N	1	VAm	//동물
殿上人	당상관#N	1	VHn	//인간 : 
大美女	대미녀#N	1	VHn	//인간 : 世界三大美女
三大美女	3대 미녀#N	1	VHn	//인간 : 
パトラッシュ	파트라슈#N	1	VAm	//동물
大政治家	대정치가#N	1	VHn	//인간 :
イヌイット	이누이트	1	QNP	//민족명
センザンコウ	천산갑#N	1	VAm	//동물
赤の他人	생판 남#N	1	VHn	//인간 :
阿弥陀如来	아미타여래#N	1	VGn	//신(성인)
窮鼠	궁지에 몰린 쥐#N	1	VAm	//동물
おさな友達	소꿉친구#N	1	VHn	//인간 :
本諸子	혼모로코#N	1	VAm	//동물 : 일본 고유 어종이라 함.
ばばあ	할머니#N	1	VHn	//인간 :
曰くつきの女子	과거가 있는 여자#N	1	VHn	//인간 :
犬ッコロ	강아지#N	1	VAm	//동물
狩る者	사냥하는 자#N	1	VHn	//인간 :
狩られる者	사냥 당하는 자#N	1	VHn	//인간 :
ポッと出	풋내기#N	1	VHn	//인간 : 
半端者	어중간한 놈#N	1	VHn	//인간 : 
招かざる客	초대하지 않은 손님#N	1	VHn	//인간 : 
絵描き	그림쟁이#N	1	VHn	//인간 : 
ファーザー	파더#N	1	VHn	//인간 : 
麒麟児	기린아#N	1	VHn	//인간 : 
わんぱく	장난꾸러기#N	1	VHn	//인간 : 
トナカイ	순록#N	1	VAm	//동물
仲好し小好し	단짝#N	1	VHn	//인간 : 
ヘッポコ	풋내기#N	1	VHn	//인간 : 
マルチーズ	말티즈#N	1	VAm	//동물
表六玉	얼간이#N	1	VHn	//인간 : 
オオアリクイ	큰개미핥기#N	1	VAm	//동물
産女	임산부#N	1	VHn	//인간 : 
ウエイトレス	웨이트리스#N	1	VHn	//인간 : 
ワーカーホリック	워커홀릭#N	1	VHn	//인간 : 
ヨルムンガンド	요르문간드#N	1	VAm	//동물북유럽 신화의 괴물
ソムリエ	소믈리에#N	1	VHn	//인간 : 
足長おじさん	키다리 아저씨#N	1	VHn	//인간 : 
臆病神	겁쟁이 귀신#N	1	VHn	//인간 : 
臆病者	겁쟁이#N	1	VHn	//인간 : 
狂言回し	배후 인물#N	1	VHn	//인간 : 
ショコラティエ	쇼콜라티에#N	1	VHn	//인간 : 초콜렛 만드는 사람
亡き天才	죽은 천재#N	1	VHn	//인간 : 
亡き国王	작고한 국왕#N	1	VHn	//인간 : 
亡き両親	돌아가신 양친#N	1	VHn	//인간 : 
ジュウシマツ	십자매#N	1	VAm	//동물
天の御遣い	하늘의 사자#N	1	VHn	//인간 : 
さみしがりや	외로움쟁이#N	1	VHn	//인간 : 
せっかちさん	성급한씨#N	1	VHn	//인간 : 
くるみ割人形	호두까기 인형#N	1	VHn	//인간 : 
かぎっ子	맞벌이집 아이#N	1	VHn	//인간 : 
鍵っ子	맞벌이집 아이#N	1	VHn	//인간 : 
へたれ弟	멍청이 남동생#N	1	VHn	//인간 : 
鬼武者	귀무자#N	1	VHn	//인간 : 
ひとり娘	외동딸#N	1	VHn	//인간 : 
黙り屋	과묵한 사람#N	1	VHn	//인간 : 
障がい者	장애인#N	1	VHn	//인간 : 
チョウザメ	철갑상어#N	1	QAC	//어류
笛吹き男	피리 부는 사나이#N	1	VHn	//인간 : 
執刀医	집도의#N	1	VHn	//인간 : 
すけこまし	여자 낚시꾼#N	1	VHn	//인간 : 
スケコマシ	여자 낚시꾼#N	1	VHn	//인간 : 
あぶらむし	진딧물#N	1	VAm	//동물
アブラムシ	진딧물#N	1	VAm	//동물
打ち手	치는 자#N	1	VAm	//동물
嬢さん	아가씨#N	1	VHn	//인간 : 
フンコロガシ	말똥구리#N	1	VAm	//동물
海豚	돌고래#N	1	VAm	//동물
蜈蚣	지네#N	1	VAm	//동물
筋者	스지몽#N	1	VHn	//인간 : 
屑虫	쓰레기 벌레#N	1	VAm	//동물
手妻使い	요술쟁이#N	1	VHn	//인간 : 
旗本	쇼군 직속#N	1	VHn	//인간 : 
真打	신우치[眞打]#N	1	VHn	//인간 : 
マブダチ	절친#N	1	VHn	//인간 : 
商売敵	경쟁업자#N	1	VHn	//인간 : 
ド素人	생초짜#N	1	VHn	//인간 : 
口裂け女	입 찢어진 여자#N	1	VHn	//인간 : 
育ての親	양부모#N	1	VHn	//인간 : 
孝行息子	효자#N	1	VHn	//인간 : 
女剣闘士	여검투사#N	1	VHn	//인간 : 
弓兵	궁병#N	1	VHn	//인간 : 
大ばか者	왕바보#N	1	VHn	//인간 : 
化けもの	괴물#N	1	VHn	//인간 : 
女兵士	여병사#N	1	VHn	//인간 : 
中年女性	중년 여성#N	1	VHn	//인간 : 
オトモダチ	친구#N	1	VHn	//인간 : 
回りの人	주변 사람#N	1	VHn	//인간 : 
我が主	우리 주님#N	1	VHn	//인간 : 
大隊長	대대장	우리 주님#N	1	VHn	//인간 : 
にゃんこ	야옹이#N	1	VHn	//인간 :
豪剣士	검호#N	1	VHn	//인간 :
嫌われ者	기피되는 사람#N	1	VHn	//인간 :
太乙真人	태을진인#N	1	VHn	//인간 :
太上老君	태상노군#N	1	VHn	//인간 :
町人	마을 사람#N	1	VHn	//인간 :
金環三結	금환삼결#N	1	VHn	//인간 :
帯来洞主	대래동주#N	1	VHn	//인간 :
徐晃	서황#N	1	VHn	//인간 :
古馴染み	오랜 친구#N	1	VHn	//인간 :
役たたずめ	쓸모 없는 놈#N	1	VHn	//인간 :
役立たずめ	쓸모 없는 놈#N	1	VHn	//인간 :
食わせ者	엉뚱한 사람#N	1	VHn	//인간 :
見かけない方	못보던 분#N	1	VHn	//인간 :
かわいこちゃん	귀여운 아이#N	1	VHn	//인간 :
かわい子ちゃん	귀여운 아이#N	1	VHn	//인간 :
可愛子ちゃん	귀여운 아이#N	1	VHn	//인간 :
いかれ野郎	정신나간 놈#N	1	VHn	//인간 :
ならず者	불량배#N	1	VHn	//인간 :
男の娘	남자 아가씨#N	1	VHn	//인간 :
愛されしもの	사랑 받는 자#N	1	VHn	//인간 :
ガキんちょ	꼬맹이#N	1	VHn	//인간 :
ぶりっ子	내숭녀#N	1	VHn	//인간 : どうもセフィさんはとぼけていたり、ぶりっ子している様子でもない。
ぶりっこ	내숭녀#N	1	VHn	//인간 : どうもセフィさんはとぼけていたり、ぶりっ子している様子でもない。
役立たず共	쓸모없는 것들#N	1	VHn	//인간 : 
やきもち焼き	질투쟁이#N	1	VHn	//인간 : 
用務員さん	용무원씨#N	1	VHn	//인간 : 
ババア	할멈#N	1	VHn	//인간 : ババアには用がないから
虫野郎	벌레 자식	1	VHn	//인간 
ヌーディスト	누디스트	1	VHn	//인간
女郎	유녀[女郞]#N	1
ゆーしゃさま	용사님#N	1	VHn	//인간
看板娘	간판 아가씨#N	1	VHn	//인간
すっとこどっこい	멍청이#N	1	VHn	//인간 : 신사 행사에서 장단 맞추는 소리라고 함. このすっとこどっこいめ
色狂い	색광#N	1	VAm	// :동물
雄馬	수말#N	1	VAm	// :동물
雌馬	암말#N	1	VAm	// :동물
わんこ	멍멍이#N	1	VAm	// :동물
わんこう	멍멍이#N	1	VAm	// :동물
タテゴトアザラシ	하프물범#N	1	VAm	// :동물
貰い手	받아갈 사람#N	1	VHn	//인간
もらい手	받아갈 사람#N	1	VHn	//인간
学生崩れ	퇴물 학생#N	1	VHn	//인간
役者崩れ	퇴물 배우#N	1	VHn	//인간
傭兵崩れ	퇴물 용병#N	1	VHn	//인간
やくざ崩れ	퇴물 야쿠자#N	1	VHn	//인간
んどくさがり屋	귀찮음쟁이#N	1	VHn	//인간
働き手	일꾼#N	1	VHn	//인간
炭鉱夫	탄광부#N	1	VHn	//인간
ミドリムシ	초록벌레	1	VAm	// :동물
咎人	죄인#N	1	VHn	//인간
化け猫	바케네코	1	VAm	// :동물
神の使い	신의 사자#N	1	VHn	//인간
英雄騎士	영웅 기사#N	1	VHn	//인간 : 
思い人	좋아하는 사람#N	1	VHn	//인간 : 
守護霊	수호령#N	1	VHn	//인간 : 
大恩人	대은인#N	1	VHn	//인간 : 
篭の中の鳥	새장 속의 새	1	VAm	// :동물
導き手	인도자#N	1	VHn	//인간 : 
あたいたち	우리들#N	1	VHn	//인간 : 
両部員	양 부원#N	1	VHn	//인간 : 
手長猿	긴팔 원숭이	1	VAm	// :동물
お客人	손님#N	1	VHn	//인간 : 
守り手	수호자#N	1	VHn	//인간 : 
月ノ輪熊	반달곰	1	VAm	// :동물
月の輪熊	반달곰	1	VAm	// :동물
ニホンザル	일본 원숭이	1	VAm	// :동물
デカブツ	멍청이#N	1	VHn	//인간 : 
待女	시녀#N	1	VHn	//인간 : 
婿候補	사위 후보#N	1	VHn	//인간 : 
探し人	찾는 사람#N	1	VHn	//인간 : 
眼鏡っ子	안경녀#N	1	VHn	//인간 : 
お目付役	감시역#N	1	VHn	//인간 : 
蛟龍	교룡	1	VAm	// :동물
国主	국주#N	1	VHn	//인간 : 
人間風情	인간 따위#N	1	VHn	//인간 : 
私風情	저 따위#N	1	VHn	//인간 : 
女剣士	여검사#N	1	VHn	//인간 : 
大英雄	대영웅#N	1	VHn	//인간 :
大切な人間	소중한 인간#N	1	VHn	//인간 :
大鷲	참수리	1	VAm	// :동물
万安隠者	만안은자#N	1	VHn	//인간 :
木鹿大王	목록대왕#N	1	VHn	//인간 :
百人長	백인장#N	1	VHn	//인간 :
封印獣	봉인수	1	VAm	// :동물
卑しん坊	걸귀#N	1	VHn	//인간 :
//私の主人	저의 주인#N	1	VHn	//인간 :
主人様	주인님#N	1	VHn	//인간 :
舎弟	사제[舍弟]#N	1	VHn	//인간 :
山地乳	야마치치#N	1	VHn	//인간 : 요괴이름
賞金稼ぎ	현상금 사냥꾼#N	1	VHn	//인간 
小袖手	코소데노테#N	1	VHn	//인간 : 요괴이름
召喚獣	소환수	1	VAm	// :동물
率土之民	온 백성#N	1	VHn	//인간
率土	온 백성#N	1	VHn	//인간 : 
右に出る者	비길 자#N	1	VHn	//인간 : 右に出る者がいない
人斬り鬼	사람베는 귀신#N	1	VHn	//인간 : 
紫虚上人	자허상인#N	1	VHn	//인간 :
姐御	누님#N	1	VHn	//인간 :
切り込み隊長	돌격 대장#N	1	VHn	//인간 :
曾お婆様	증조모님#N	1	VHn	//인간 :
護り手	지킴이#N	1	VHn	//인간 :
荒事師	액션 배우#N	1	VHn	//인간 :
街娘	마을 아가씨#N	1	VHn	//인간 :
御使い	사도#N	1	VHn	//인간 :
ちびっこ	꼬맹이#N	1	VHn	//인간 :
ヒヨッ子	병아리	1	VAm	// :동물
スカンク	스컹크	1	VAm	// :동물
木偶の坊	멍청이#N	1	VHn	//인간 :
光り物の魚	등푸른 생선	1	VAm	// :동물
小舅	처남#N	1	VHn	//인간 :
目玉選手	주력선수#N	1	VHn	//인간 :
ファイター	파이터#N	1	VHn	//인간 :
愛戦士	애전사#N	1	VHn	//인간 :
祓魔師	퇴마사#N	1	VHn	//인간 :
妹背	부부#N	1	VHn	//인간 :
ブラックバス	블랙 배스	1	VAm	// :동물
クイーン	퀸#N	1	VHn	//인간 :
インディアン	인디언#N	1	VHn	//인간 :
正規職員	정규직원#N	1	VHn	//인간 :
平職員	평직원#N	1	VHn	//인간 :
準職員	준직원#N	1	VHn	//인간 :
百鬼王	백귀왕#N	1	VHn	//인간 :
組員	조원#N	1	VHn	//인간 :
弑し屋	암살자#N	1	VHn	//인간 :
アダルト	어덜트#N	1	VHn	//인간 :
秋田犬	아키타견	1	VAm	// :동물
駄犬	똥개	1	VAm	// :동물
フォロワー	팔로워#N	1	VHn	//인간 :
かしまし娘	소란스런 아가씨#N	1	VHn	//인간 :
狩猟犬	사냥개	1	VAm	// :동물
大明神	다이묘진#N	1	VGn	// :신(성인)
白身魚	흰살 생선	1	VAm	// :동물
へなちょこ	애송이#N	1	VHn	//인간 :
メガネザル	안경 원숭이	1	VAm	// :동물
荒脛神	아라하바키노카미#N	1	VGn	// :신(성인)
トウヘンボク	벽창호#N	1	VHn	//인간 :
百名	백명	1	VHn	//인간 :
わからず屋	고집쟁이#N	1	VHn	//인간 :
ちくしょうめ	젠장할 놈#N	1	VHn	//인간 :
闘将	투장#N	1	VHn	//인간 :
白騎士	백기사#N	1	VHn	//인간 :
王騎士	왕기사#N	1	VHn	//인간 :
屁ひり	방귀쟁이#N	1	VHn	//인간 :
屁放り	방귀쟁이#N	1	VHn	//인간 :
屁っぴり	방귀쟁이#N	1	VHn	//인간 :
屁っ放り	방귀쟁이#N	1	VHn	//인간 :
晴れ男	쾌청남#N	1	VHn	//인간 :
晴れ女	쾌청녀#N	1	VHn	//인간 :
しょじょ	처녀#N	1	VHn	//인간 :
ぼっちゃま	도련님#N	1	VHn	//인간 :
洟垂らし	코흘리개#N	1	VHn	//인간 :
洟垂れ	코흘리개#N	1	VHn	//인간 :
うちゅうじん	우주인#N	1	VHn	//인간 :
呑気者	태평한 사람#N	1	VHn	//인간 :
ミュージッシャン	뮤지션#N	1	VHn	//인간 :
ノラネコ	길고양이	1	VAm	// :동물
ヤンチャボーズ	응석꾸러기#N	1	VHn	//인간 :
やんちゃ坊主	응석꾸러기#N	1	VHn	//인간 :
ダダっ子	응석쟁이#N	1	VHn	//인간 :
座敷わらし	좌부동자#N	1	VHn	//인간 :
ハンザイシャ	범죄자#N	1	VHn	//인간 :
こんにゃろ	이 자식#N	1	VHn	//인간 :
こんにゃろめ	이 자식#N	1	VHn	//인간 :
あんにゃろ	저 자식#N	1	VHn	//인간 :
あんにゃろめ	저 자식#N	1	VHn	//인간 :
あたい達	우리들#N	1	VHn	//인간 :
だだっこ	응석꾸러기#N	1	VHn	//인간 :
おんみょうじ	음양사#N	1	VHn	//인간 :
オッチョコチョイ	덜렁이#N	1	VHn	//인간 :
おたんこ茄子	얼간이#N	1	VHn	//인간 :
おたんこなす	얼간이#N	1	VHn	//인간 :
御馬鹿	바보#N	1	VHn	//인간 :
空け者	멍청이#N	1	VHn	//인간 :
お人良し	호인#N	1	VHn	//인간 :
きんぴら	용감한 사람#N	1	VHn	//인간 :
こんにゃろう	이 녀석#N	1	VHn	//인간 :
ひとりっ子	외동아이#N	1	VHn	//인간 :
カンバン娘	간판 아가씨#N	1	VHn	//인간 :
八十禍津日	아소마가츠히#N	1	VHn	//인간 : 신 이름
照れ屋	수줍음쟁이#N	1	VHn	//인간 : 신 이름
三葉虫	삼엽충	1	VAm	// :동물
跳ねっ返り	말괄량이#N	1	VHn	//인간
はねっかえり	말괄량이#N	1	VHn	//인간
ははおや	어머니#N	1	VHn	//인간
ワルガキ	못된 꼬마#N	1	VHn	//인간
落とし神	함락신#N	1	VHn	//인간
きれい好き	깔끔한걸 좋아하는 사람#N#N	1	VHn	//인간
綺麗好き	깔끔한걸 좋아하는 사람#N	1	VHn	//인간 : 
蟷螂	사마귀	1	VAm	// :동물
あにうえ様	형님#N	1	VHn	//인간
あにうえさま	형님#N	1	VHn	//인간
部屋住み	헤야즈미[部屋住み]#N	1	VHn	//인간
担ぎ手	가마꾼#N	1	VHn	//인간
姪御	조카딸#N	1	VHn	//인간
若侍	젊은 무사#N	1	VHn	//인간
生侍	풋내기 무사#N	1	VHn	//인간
悴侍	하급 무사#N	1	VHn	//인간
平侍	하급 무사#N	1	VHn	//인간
諸大夫	제대부[諸大夫]#N	1	VHn	//인간
引きニート	히키 니트#N	1	VHn	//인간
金屋子神	카나야고카미#N	1	VGn	// :신(성인)
弥都波能売神	미츠하노메노카미#N	1	VGn	// :신(성인)
おおやしろ	오오야시로	1	VGn	// :신(성인)
仔馬	망아지	1	VAm	// :동물
縁戚	친척	1	VHn	//인간
田吾作	시골뜨기#N	1	VGn	// :신(성인)
猿田彦	사루타히코	1	VGn	// :신(성인)
惡鬼	악귀	1	VGn	// :신(성인)
軍人	군인#N	1	VHn	//인간
蔵主	창고주#N	1	VHn	//인간
ぼく達	우리들#N	1	VHn	//인간
辣腕家	수완가	1	VHn	//인간
不精者	게으름뱅이	1	VHn	//인간
虫けら共	버러지들#N	1	VHn	//인간
箱入り娘	규중 처녀#N	1	VHn	//인간
ひきこもり	히키코모리#N	1	VHn	//인간
刑務官	형무관#N	1	VHn	//인간
市井人	서민#N	1	VHn	//인간
にんげん	인간	1	VHn	//인간
木地師	목공장이	1	VHn	//인간
侍大将	시대장[侍大將]#N	1	VHn	//인간
あたいら	우리들#N	1	VHn	//인간
不帰の客	불귀의 객	1	VHn	//인간
もののけ	귀신	1	VGn	// :신(성인)
鼠達	쥐들	1	VAm	// :동물
仕事人間	일만 하는 인간	1	VHn	//인간
義姉妹	의자매	1	VHn	//인간
お館様	주인어른#N	1	VHn	//인간
カマドウマ	곱등이	1	VAm	// :동물
召喚主	소환주#N	1	VHn	//인간
//どれい	노예	1	VHn	//인간
尻軽女	헤픈 여자	1	VHn	//인간
英雄王	영웅왕#N	1	VHn	//인간
商人さん	상인씨#N	1	VHn	//인간
ひぐらし	쓰르라미	1	VAm	// :동물
化生の者	도깨비#N	1	VHn	//인간
山師	산사[山師]#N	1	VHn	//인간
妹娘	작은 딸#N	1	VHn	//인간
祟り神	재앙신#N	1	VGn	// :신(성인)
犬侍	개 사무라이#N	1	VHn	//인간
//爺い	할아버지#N	1	VHn	//인간
トリックスター	트릭스터#N	1	VHn	//인간
かぐや姫	카구야 공주#N	1	VHn	//인간
猫被り娘	내숭녀#N	1	VHn	//인간
大神官	대신관#N	1	VHn	//인간
獅子王	사자왕#N	1	VHn	//인간
世界ランカー	세계 랭커#N	1	VHn	//인간
えぶりばでぃ	에브리바디#N	1	VHn	//인간
婿養子	데릴사위#N	1	VHn	//인간
誰かしら	누군가#N	1	VHn	//인간 いつも誰かしらがいて賑やかな事が多い。
うっかりやさん	깜빡쟁이씨#N	1	VHn	//인간
うっかりさん	깜빡쟁이씨#N	1	VHn	//인간
うっかり屋	깜빡쟁이#N	1	VHn	//인간
来園者	방문자#N	1	VHn	//인간
オシャレさん	멋쟁이씨#N	1	VHn	//인간
女嫌い	여자 혐오증#N	1	VHn	//인간
男嫌い	남자 혐오증#N	1	VHn	//인간
賭け嫌い	도박 혐오증#N	1	VHn	//인간
針子	재봉사#N	1	VHn	//인간
噺家	만담가#N	1	VHn	//인간
バカアニキ	바보 오빠#N	1	VHn	//인간
わかもの	젊은이#N	1	VHn	//인간
御領主	영주#N	1	VHn	//인간 御領主様のことです
大食らい	대식가#N	1	VHn	//인간
非人格者	비인격자#N	1	VHn	//인간
こぞう	애송이#N	1	VHn	//인간
天竜	천룡	1	VAm	// :동물
四大竜	4대룡	1	VAm	// :동물
豆柴	마메시바	1	VAm	// :동물
豆柴犬	마메시바견	1	VAm	// :동물
まめしば	마메시바	1	VAm	// :동물
インクバス	인큐버스#N	1	VHn	//인간
インキュバス	인큐버스#N	1	VHn	//인간
センター長殿	센터장님#N	1	VHn	//인간
みどりご	젖먹이#N	1	VHn	//인간
赤兎馬	적토마	1	VAm	// :동물
腐女子	부녀자#N	1	VHn	//인간
ブギーマン	부기맨#N	1	VHn	//인간
白魔術師	백마술사#N	1	VHn	//인간
人攫い	유괴범#N	1	VHn	//인간
寂しがり屋	외로움쟁이#N	1	VHn	//인간
さびしんぼう	외로움쟁이#N	1	VHn	//인간
手前達	저手희#N	1	VHn	//인간
ほら貝	소라고동	1	VAm	// :동물
兄君	오라버니#N	1	VHn	//인간
兄君様	오라버님#N	1	VHn	//인간
新米兵士	햇병아리 병사#N	1	VHn	//인간
新米兵	햇병아리 병사#N	1	VHn	//인간
男の子供	남자 아이#N	1	VHn	//인간
女の子供	여자 아이#N	1	VHn	//인간
噛ませ犬	당하는 역할#N	1	VHn	//인간
呪い師	주술사#N	1	VHn	//인간
歌妓	가기[歌妓]#N	1	VHn	//인간
ふたなり	후타나리#N	1	VHn	//인간
取り立て屋	독촉꾼#N	1	VHn	//인간
取立て屋	독촉꾼#N	1	VHn	//인간
大金持ち	큰 부자#N	1	VHn	//인간
小金持ち	작은 부자#N	1	VHn	//인간
大神父	대신부#N	1	VHn	//인간
ハリセンボン	가시복	1	QAC	// :어류
欲張り	욕심쟁이#N	1	VHn	//인간
肥後もっこす	히고 고집쟁이#N	1	VHn	//인간
ばあや	할멈#N	1	VHn	//인간
王弟	왕제[王弟]#N	1	VHn	//인간
老魔女	노마녀#N	1	VHn	//인간
癒し手	치유사#N	1	VHn	//인간
拠る者	의지할 사람#N	1	VHn	//인간
端女郎	하급 유녀#N	1	VHn	//인간
端者	말단인 사람#N	1	VHn	//인간
引き馬	귀인용 접객마[引き馬]	1	VAm	// :동물
依頼主	의뢰주#N	1	VHn	//인간 依頼主であったとしても、
叔父上	숙부님#N	1	VHn	//인간
狼人族	낭인족[狼人族]#N	1	VHn	//인간
王父	왕부[王父]#N	1	VHn	//인간
王母	왕모[王母]#N	1	VHn	//인간
幼稚園児	유치원 아이#N	1	VHn	//인간
第一子	첫 아이#N	1	VHn	//인간
若主人	젊은 주인#N	1	VHn	//인간
準主役	준주역#N	1	VHn	//인간
御祖父様	조부님#N	1	VHn	//인간
仕掛け人	청부업자#N	1	VHn	//인간
来場者	방문자#N	1	VHn	//인간
地味子	수수한 아이#N	1	VHn	//인간
大口魚	대구	1	VAm	// :동물
朝啼き鳥	아침에 우는 새	1	VAm	// :동물
甘えたがり屋	응석쟁이#N	1	VHn	//인간
妖かし	요괴#N	1	VHn	//인간
抜け忍	탈주 닌자#N	1	VHn	//인간
おべっか使い	아첨꾼#N	1	VHn	//인간
ビリギャル	꼴찌 소녀#N	1	VHn	//인간
筋肉達磨	근육 달마#N	1	VHn	//인간
傷負い人	상처입은 사람#N	1	VHn	//인간
あくま	악마#N	1	VHn	//인간
蛞蝓	민달팽이	1	VAm	// :동물
飛竜騎士	비룡기사#N	1	VHn	//인간
女魔導士	여마도사#N	1	VHn	//인간
女賊	여적#N	1	VHn	//인간
アバズレ女	닳고 닳은 여자#N	1	VHn	//인간
あばずれ女	닳고 닳은 여자#N	1	VHn	//인간
阿婆擦れ女	닳고 닳은 여자#N	1	VHn	//인간
蟇蛙	두꺼비	1	VAm	// :동물
はげオヤジ	대머리 아저씨#N	1	VHn	//인간
はげおやじ	대머리 아저씨#N	1	VHn	//인간
社畜	사축[社畜]#N	1	VHn	//인간
天皇陛下	천황 폐하#N	1	VHn	//인간
浅学の徒	배움이 얕은 무리#N	1	VHn	//인간
警備犬	경비견	1	VAm	// :동물
萌やしっ子	허약한 아이#N	1	VHn	//인간
もやしっ子	허약한 아이#N	1	VHn	//인간
軟弱もやしっ子	비실비실한 아이#N	1	VHn	//인간
亜人	아인[亞人]#N	1	VHn	//인간
猫かぶり女子	내숭 떠는 여자#N	1	VHn	//인간
猫かぶり女	내숭녀#N	1	VHn	//인간
猫被り女	내숭녀#N	1	VHn	//인간
猫被り女子	내숭 떠는 여자#N	1	VHn	//인간
婿取り娘	데릴사위를 얻을 딸#N	1	VHn	//인간
イリュージョニスト	일루셔니스트#N	1	VHn	//인간
来たりし者	온 자#N	1	VHn	//인간 深き淵の世界より来たりし者
豚達	돼지들#N	1	VHn	//인간
倉庫番	창고지기#N	1	VHn	//인간
御二方	두분#N	1	VHn	//인간
ドードー鳥	도도새	1	VAm	// :동물
人たらし	사기꾼	1	VHn	//인간
人誑し	사기꾼	1	VHn	//인간
人タラシ	사기꾼	1	VHn	//인간 天性の人タラシであるトム
海月	해파리	1	VAm	// :동물
人食い蟻	식인 개미	1	VAm	// :동물
人食い鮫	식인 상어	1	VAm	// :동물
神君	신군[神君]#N	1	VHn	//인간
飼い主	사육주#N	1	VHn	//인간
飼い主人	사육주#N	1	VHn	//인간
義人	의인#N	1	VHn	//인간
愛奴隷	애노예#N	1	VHn	//인간
スルメイカ	살오징어	1	VAm	// :동물
飯炊き女	부엌데기#N	1	VHn	//인간
邪神	사신	1	VGn	// :신(성인)
あらくれ達	난폭자들#N	1	VHn	//인간
徒士侍	하급 사무라이#N	1	VHn	//인간
実の兄弟	친형제#N	1	VHn	//인간
カワウソ	수달	1	VAm	// :동물
川獺	수달	1	VAm	// :동물
ペテン師	사기꾼#N	1	VHn	//인간
ぺてん師	사기꾼#N	1	VHn	//인간
獄長	옥장#N	1	VHn	//인간
恥かきっ子	늦둥이#N	1	VHn	//인간
お主達	너희들#N	1	VHn	//인간
お主さま	주인님#N	1	VHn	//인간
お主さん	주인씨#N	1	VHn	//인간
お主ちゃん	주인쨩#N	1	VHn	//인간
あやつり人形	꼭두각시	1	VHn	//인간
牛達	소들	1	VAm	// :동물

//'명사 (속성 있음)
なわばり	나와바리	1	VPl	// :장소
漫喫	만화 카페	1	VPl	// :장소
おいなりさん	유부초밥	1	VFd	// :음식(음료)
お稲荷さん	유부초밥	1	VFd	// :음식(음료)
御稲荷さん	유부초밥	1	VFd	// :음식(음료)
学園長室	학원장실	1	VPl	// :장소
真向い	정면	1	UDr	// :방향
音漏れ	누설음	1	UHr	// :청음(소리) 상태
ぶなしめじ	느티만가닥버섯	1	VPt	// :식물
つるばら	덩굴장미	1	VPt	// :식물
蔓薔薇	덩굴장미	1	VPt	// :식물
クハノウ漬け	쿠하노우츠케	1	VFd	// :음식(음료)
盆と正月	추석과 정월	1	UMe	// :시간
プロムナード	프롬나드	1	VPl	// :장소
囁き声	속삭이는 소리	1	UHr	// :청음(소리) 상태
いづこ	어디	1	VPl	// :장소
お下劣	비열함	1	UYi	// :인간&동물 내적 형용
親分肌	두목 기질	1	UYi	// :인간&동물 내적 형용
交渉術	교섭술	1	UTt	// :기술
二足の動物	2족 동물	1	VAm	// :동물
ひと冬	한 겨울	1	UMe	// :시간
躁うつ病	조울증	1	UTi	// :질병
ケモミミ	동물 귀	1	VBp	// :신체부위
後ろ頭	뒷머리	1	VBp	// :신체부위
囀さえずり	지저귐	1	UHr	// :음향&소리 상태
エルボー	엘보	1	VBp	// :신체부위
女蕩し	여자 꼬득이기	1	UTt	// :기술
人蕩し	사람 꼬득이기	1	UTt	// :기술
肉慾	육욕	1	UFl	// :감정
冬籠り穴	겨울잠 굴	1	VPl	// :장소
食事処	식사처	1	VPl	// :장소
病の床	병상	1	VPl	// :장소
稽古場	연습장	1	VPl	// :장소
煮干	말린 멸치	1	VFd	// :음식(음료)
闇鍋	야미나베	1	VFd	// :음식(음료)
雪平鍋	양은냄비	1	VCk	// :주방기기
楽市	락시[樂市]	1	VPl	// :장소
楽座	락좌[樂座]	1	VPl	// :장소
嵌め技	얍삽한 기술	1	UTt	// :기술
山裾	산기슭	1	VPl	// :장소
たくあん	단무지	1	VFd	// :음식(음료)
稲穂	벼이삭	1	VPt	// :식물
話声	말소리	1	UHr	// :음향&소리 상태
既往症	과거 앓았던 병	1	UTi	// :질병
うま味	감칠맛	1	UYa	// :맛(미각)
檀上	단상	1	VPl	// :장소
空き教室	빈 교실	1	VPl	// :장소
炊き込みご飯	다키코미밥	1	VFd	// :음식(음료)
炊き込みごはん	다키코미밥	1	VFd	// :음식(음료)
金平ごぼう	우엉 조림	1	VFd	// :음식(음료)
船着き場	선착장	1	VPl	// :장소
夜ご飯	저녁밥	1	VFd	// :음식(음료)
鶏のささ身	닭 가슴살	1	VFd	// :음식(음료)
鶏のささみ	닭 가슴살	1	VFd	// :음식(음료)
鶏の笹身	닭 가슴살	1	VFd	// :음식(음료)
ちくしょうめし	젠장맞은 밥	1	VFd	// :음식(음료)
ぱじゃま	파자마	1	VCp	// :의복
臓腑	오장육부	1	VBp	// :신체부위
喚き声	외치는 소리	1	UTs	// :발화(언어수단)
前のめり	기우뚱	1	//蹴躓いて前のめりになる朝陽を
叫び声	외침	1	UHr	// :음향&소리 상태
向こう見ず	무모함	1	UYi	// :인간&동물 내적 형용
額冠	서클릿	1	VAc	// :장신구
ブロードウエー	브로드웨이	1	VPl	//장소
ふんいき	분위기	1	UYi	//인간&동물 내적 형용 : 상당히 자주 쓰이는 듯 : いつもとふんいきが違うみたい
喉下	목 아래	1	VBp	//신체부위
地下牢	지하 감옥	1	VPl	//장소
大森林	대삼림	1	VPl	//장소
城下町	성 주변 마을	1	VPl	//장소
考え時	생각할 때	1	UMe	//시간:確かに今が考え時かもしれない。
分身の術	분신술	1	UTt	//기술
焦りっぷり	초조한 모습	1	UYh	//인간&동물 외적 형용
乱れっぷり	혼란스런 모습	1	UYh	//인간&동물 외적 형용
富みっぷり	풍부한 모습	1	UYh	//인간&동물 외적 형용
濡れっぷり	젖은 모습	1	UYh	// :인간&동물 외적 형용
見せっぷり	보여주는 모습	1	UYh	// :인간&동물 외적 형용
小心っぷり	소심한 모습	1	UYh	// :인간&동물 외적 형용
甘えっぷり	어리광부리는 모습	1	UYh	// :인간&동물 외적 형용
しゃぶりっぷり	빠는 모습	1	UYh	// :인간&동물 외적 형용
行きっぷり	가는 모습	1	UYh	// :인간&동물 외적 형용
化けっぷり	변한 모습	1	UYh	// :인간&동물 외적 형용
慌てっぷり	당황하는 모습	1	UYh	// :인간&동물 외적 형용
あわてっぷり	당황하는 모습	1	UYh	// :인간&동물 외적 형용
びびりっぷり	위축되는 모습	1	UYh	// :인간&동물 외적 형용
逃げっぷり	도망치는 모습	1	UYh	// :인간&동물 외적 형용
こわばりっぷり	굳어지는 모습	1	UYh	// :인간&동물 외적 형용 ♞強張りっぷり
働きっぷり	일하는 모습	1	UYh	// :인간&동물 외적 형용
間抜けっぷり	얼빠진 모습	1	UYh	// :인간&동물 외적 형용
折れた剣	부러진 검	1	VPe	//도구
斬り込み部隊	특공 부대	1	VGt	//집합
見かけない顔ぶれ	못보던 멤버#N	1	VHn	//인간 :
見かけない顔	못보던 얼굴#N	1	VHn	//인간 :
口説き文句	작업 대사	1	UTs	//발화
カンパニー	컴패니	1	VPl	//장소
真昼間	대낮	1	UMe	//시간
あそこらへん	저 주변	1	VPl	//장소
あそこら辺	저 주변	1	VPl	//장소
戦慄き声	전율하는 소리	1	UHr	//음향&소리 상태
勝ち鬨	승리의 함성	1	UHr	//음향&소리 상태
次の一手	다음 한 수	1	UMn	//수단
かたやきそば	카타야키소바	1	VFd	// :음식(음료)
やきそば	야키소바	1	VFd	// :음식(음료)
猪肉	멧돼지고기	1	VFd	// :음식(음료)
中腹	중턱[中腹]	1	VPl	//장소
山中腹	산중턱[中腹]	1	VPl	//장소
鬨の声	함성	1	UHr	//음향&소리 상태
捨て場所	버릴 장소	1	VPl	//장소
そこら辺	그 근처	1	VPl	//장소
シャングリラ	샹그릴라	1	QCT	//도시(지명)명
作り話	지어낸 이야기	1	UAr	//예술활동
アーマー	아머	1	VCp	//의복
アールグレイ	얼그레이	1	VFd	//음식(음료) :
あえぎ	헐떡거림	1	UHr	//음성(음향) :
アエギ声	허덕이는 소리	1	UHr	//음성(음향) :
あかね色	붉은색	1	UCr	//색상
あがり症	울렁증	1	UTi	//질병 :
アサルトライフル	어셜트라이플	1	VTw	//무기 :
アダルティ	어덜티	1	UYh	//외적 형용
アチコチ	여기저기	1	VPl	//장소 :
あったま	머리	1	VBp	//신체부위 : 
アップルティー	애플티	1	VFd	//음식(음료) :
アトランチス	아틀란티스	1	QCTVPl	//장소, 지명 :
アトランティス	아틀란티스	1	QCTVPl	//장소, 지명 :
アナル	애널	1	VBp	//신체부위 : 
アホ面	바보 같은 얼굴	1	VBp	//신체부위 : 
アミュレット	아뮬렛	1	VAc	//장신구
アメジスト	자수정	1	VJw	//보석
あんころもち	팥소떡	1	VFd	//음식(음료) :
アンバタ	단팥버터빵	1	VFd	//음식(음료) :
あんばた	단팥버터빵	1	VFd	//음식(음료) :
あんパン	팥빵	1	VFd	//음식(음료) :
あんぱん	팥빵	1	VFd	//음식(음료) :
あんみつ	앙미츠	1	VFd	//음식(음료) :
イイトコロ	좋은 곳	1	VPl	//장소 :
柔手	부드러운 손	1	VBp	//신체부위 : 
脹脛	장딴지	1	VBp	//신체부위 : 
イキ声	가는 소리	1	UHr	//음성(음향) :
イキ顔	가는 얼굴	1	VBp	//신체부위 : 
イケ面	멋진 얼굴	1	VBp	//신체부위 : 
イジメ甲斐	괴롭히는 보람	1	UFl	//감정
いじめ甲斐	괴롭히는 보람	1	UFl	//감정
イタメシ	이탈리아밥	1	VFd	//음식(음료) :
イチゴ味	딸기맛	1	UYa	//맛(미각) :
イビキ	코고는 소리	1	UHr	//음성(음향) :
イメクラ	이미지클럽	1	VPl	//장소 :
イヤフォン	이어폰	1	VPe	//도구
イヤホン	이어폰	1	VPe	//도구
ヴァギナ	바기나	1	VBp	//신체부위 : 
ヴィジュアルノヴェル	비주얼노벨	1	VBk	//책
うす桃色	연분홍	1	UCr	//색상
うどんそば	우동소바	1	VFd	//음식(음료) : 
ウメボシ	매실장아찌	1	VFd	//음식(음료) :
ウンコ	똥	1	VLu	//분비물
ウンチ	응가	1	VLu	//분비물
エイチツーオー	H2O	1	VLq	//액체
エキゾチック	이그자틱	1	UYh	//외적 형용
エクスカリバー	엑스칼리버	1	VTw	//무기 :
エルボードロップ	엘보드롭	1	UTt	//기술
オ○ンコ	보지	1	VBp	//신체부위 : 
お○んこ	보지	1	VBp	//신체부위 : 
オ○ンチン	자지	1	VBp	//신체부위 : 
お○んちん	자지	1	VBp	//신체부위 : 
オ○ンポ	자지	1	VBp	//신체부위 : 
オカズ	반찬	1	VFd	//음식(음료) :
おごりどころ	한턱 쏠 곳	1	VPl	//장소
オシオキ	벌	1	UPp	//상&벌
おしおき	벌	1	UPp	//상&벌
オシッコ	오줌	1	VLu	//분비물
オシリ	엉덩이	1	VBp	//신체부위 : 
オスマラ	수컷음경	1	VBp	//신체부위 :
オチ○チン	자지	1	VBp	//신체부위 :
おチ○チン	자지	1	VBp	//신체부위 :
おち○ちん	자지	1	VBp	//신체부위 : 
オチ○ポ	자지	1	VBp	//신체부위 :
おち○ぽ	자지	1	VBp	//신체부위 :
オチ〇チン	자지	1	VBp	//신체부위 :
おチン○ン	자지	1	VBp	//신체부위 :
オチンポ	자지	1	VBp	//신체부위 : 
オチンポッ	자지	1	VBp	//신체부위 :
オツマミ	술안주	1	VFd	//음식(음료) :
オツユ	국물	1	VFd	//음식(음료) :
おツユ	국물	1	VFd	//음식(음료) : 
オナホ	오나홀	1	VPe	//도구
オナホール	오나홀	1	VPe	//도구
おへそ	배꼽	1	VBp	//신체부위 :
おべんと	도시락	1	VFd	//음식(음료) :
オマ○コ	보지	1	VBp	//신체부위 : 
おま○こ	보지	1	VBp	//신체부위 : 
オマコ	보지	1	VBp	//신체부위 : 
オマンコッ	보지	1	VBp	//신체부위 : 
オムそばパン	오므라이스빵	1	VFd	//음식(음료) : 
オムライス	오무라이스	1	VFd	//음식(음료) :
オヤツ	간식	1	VFd	//음식(음료) :
オヤツッ	간식	1	VFd	//음식(음료) :
おりんご	사과	1	QAM	//과일명
オリンポス	올림푸스	1	QCTVPl	//장소,지명 :
お家柄	집 안	1	VPl	//장소 :
お茶碗	밥공기	1	VCk	//주방기기
お茶漬け	오챠즈케	1	VFd	//음식(음료) : 
お茶請け	과자	1	VFd	//음식(음료) : 
お墓の中	무덤속	1	VPl	//장소 :
お味噌	된장	1	VFd	//음식(음료) :
お味噌汁	된장국	1	VFd	//음식(음료) :
お腹の奥	뱃속	1	VPl	//장소 :
お腹立ち	성냄	1	UFl	//감정
お仕置き	벌	1	UPp	//상&벌
お小水	소변	1	VLu	//분비물
お前ん家	너희집	1	VPl	//장소 :
お昼時	점심 때	1	UMe	//시간 :
カカト	뒤꿈치	1	VBp	//신체부위 : 
かすてら	카스테라	1	VFd	//음식(음료) :
かすり傷	찰과상	1	UTi	//질병 :
カツカレー	돈까스카레	1	VFd	//음식(음료) :
カットソー	니트	1	VCp	//의복
カップラーメン	컵라면	1	VFd	//음식(음료) :
ガマン汁	쿠퍼액	1	VLu	//분비물
カラシニコフ	칼라시니코프	1	VTw	//무기 :
きつね色	옅은 갈색	1	UCr	//색상
カレーラーメン	카레라면	1	VFd	//음식(음료) :
クサヤ	말린 자반고등어	1	VFd	//음식(음료) :
くすみ	칙칙함	1	UCr	//색상
クリトリス	클리토리스	1	VBp	//신체부위 : 
くるみ割り	호두까기	1	VPe	//도구
クロワッサン	크로와상	1	VFd	//음식(음료) :
クンニリングス	커닐링구스	1	UTt	//기술
ケイレン	경련	1	UTi	//질병 :
ゲーセン	게임센터	1	VPl	//장소 :
ケツ	엉덩이	1	VBp	//신체부위 : 
ケツの穴	엉덩이 구멍	1	VBp	//신체부위 : 
ケツマン	항문보지	1	VBp	//신체부위 : 
ケツマンコ	항문보지	1	VBp	//신체부위 : 
ケツ穴	똥구멍	1	VBp	//신체부위 : 
ゲテパン	맛없는 빵	1	VFd	//음식(음료) :
ケモノ耳	동물귀	1	VBp	//신체부위 :
けんちん汁	맑은 장국	1	VFd	//음식(음료) :
ケンポウ	권법	1	UTt	//기술
コイゴコロ	연정	1	UFl	//감정
コウエン	공원	1	VPl	//장소 :
コクピット	콕피트	1	VPl	//장소 :
ここいら	이 근처	1	VPl	//장소 :
ここら辺	이 근처	1	VPl	//장소 :
コスチューム	코스츔	1	VCp	//의복
コチュジャン	고추장	1	VFd	//음식(음료) :
コックピット	콕피트	1	VPl	//장소 :
こっちのほう	이쪽	1	UDr	//방향
ごはーん	밥	1	VFd	//음식(음료) : 
ゴムマリ	고무공	1	VRw	//놀이기구
こむら返り	장딴지 근육경련	1	UTi	//질병 :
コメカミ	관자놀이	1	VBp	//신체부위 :
コロシアム	콜로세움	1	VBl	//건축물
コロッセオ	콜로세움	1	VBl	//건축물
コンソメ味	콩소메맛	1	UYa	//맛(미각) :
コンビニ	편의점	1	VPl	//장소 :
コンビニエンスストア	컨비니언스 스토어	1	VPl	//장소 :
コンビニメシ	편의점밥	1	VFd	//음식
ご飯茶碗	밥공기	1	VCk	//주방기기
ザァメン	정액	1	VLu	//분비물
ザーメン	정액	1	VLu	//분비물
ザーメンッ	정액	1	VLu	//분비물
サイハイソックス	싸이 하이삭스	1	VCp	//의복
サラダ	샐러드	1	VFd	//음식(음료) :
さわり心地	만지는 느낌	1	UYt	//촉감
サンダル	샌들	1	VCp	//의복
ザンネン	유감	1	UFl	//감정
さ来年	내후년	1	UMe	//시간 :
シーコッコ	쉬야	1	VLu	//분비물
ジエータイ	자위대	1	VGt	//집합(군집)
ジェットコースター	제트 코스터	1	VTp	//교통수단
シシトウ	꽈리고추	1	VPt	//식물 :
ジト目	반쯤 뜬 눈	1	VBp	//신체부위 :
シャイ	샤이	1	UYi	//내적 형용 : 
ジャガイモ	감자	1	VFdVPt	//음식, 식물
シャケ缶	연어캔	1	VFd	//음식 : いわゆるシャケ缶である。
しょういんしん	소음순	1	VBp	//신체부위 : 
じょせいほるもん	여성호르몬	1	VLu	//분비물
ショットガン	샷건	1	VTw	//무기 :
ショルダーチャージ	숄더챠지	1	UTt	//기술
ションベン	소변	1	VLu	//분비물
シルバーソード	실버소드	1	VTw	//무기 :
シルバーボウ	실버보우	1	VTw	//무기 :
スクリュードライバ	스크류드라이버	1	VPe	//도구
スケイルアーマー	스케일 아머	1	VCp	//의복
スパンキング	스팽킹	1	UPp	//상&벌
スペルマ	스펌	1	VLu	//분비물
すれっからし	닳고 닳음	1	UYi	//내적 형용 : 
寸でのところ	위기의 순간	1	UMe	//시간 : 
すんでの所	위기의 순간	1	UMe	//시간 :
セイエキ	정액	1	VLu	//분비물
セーエキ	정액	1	VLu	//분비물
せーえき	정액	1	VLu	//분비물
セクシィ	섹시	1	UYh	//외적 형용
セクスィー	섹시	1	UYh	//외적 형용
ソード	소드	1	VTw	//무기 :
そら耳	환청	1	UHr	//음성(음향)
タイヤキ	붕어빵	1	VFd	//음식(음료) :
ダージリンティー	다르질링티	1	VFd	//음식(음료) :
ダイガク	대학	1	VPl	//장소 :
ダガー	대거	1	VTw	//무기 :
たこやき	타코야키	1	VFd	//음식(음료) :
たて筋	외음부[縱筋]	1	VBp	//신체부위 : 
タトゥー	타투	1	VSp	//그림
たまごやき	달걀부침	1	VFd	//음식(음료) :
タマ蹴り	불알차기	1	UTt	//기술
タラコ	명란젓	1	VFd	//음식(음료) :
タレ目	쳐진 눈	1	VBp	//신체부위 : 
ダンジョン	던전	1	VPl	//장소 :
たんぽぽ	민들레꽃	1	QAL	//꽃이름(풀이름)
タンメン	탕면	1	VFd	//음식(음료) :
チ○チン	자지	1	VBp	//신체부위 : 
チ○ポ	자지	1	VBp	//신체부위 : 
ち○ぽ	자지	1	VBp	//신체부위 : 
ちゃんこ鍋	쨩코나베	1	VFd	//음식(음료) : 
チリトリ	쓰레받기	1	VPe	//도구
ちりとり	쓰레받기	1	VPe	//도구
しなちく	죽순	1	VFd	//음식(음료) : 
炒め物	볶음요리	1	VFd	//음식(음료) : 
チンクシャ	못난 얼굴	1	VBp	//신체부위 : 
チングリ返し	チングリ返し	1	UTt	//기술
ちんぐり返し	ちんぐり返し	1	UTt	//기술
ちんぽ	자지	1	VBp	//신체부위 : 
おちんぽ	자지	1	VBp	//신체부위 : 
つばめ返し	쯔바메가에시	1	UTt	//기술
つら構え	상판떼기	1	VBp	//신체부위 :
ツルペタ	절벽가슴	1	VBp	//신체부위 : 
テイム	팀	1	VGt	//집합(군집)
ディルド	딜도	1	VPe	//도구
ディルドー	딜도	1	VPe	//도구
デカチンポ	왕자지	1	VBp	//신체부위 : 
デカパイ	왕가슴	1	VBp	//신체부위 : 
デカマラ	왕자지	1	VBp	//신체부위 : 
でか乳	왕젖	1	VBp	//신체부위 : 
でか乳輪	큰 유륜	1	VBp	//신체부위 : 
舌の根	혀뿌리	1	VBp	//신체부위 : 
てくにっく	테크닉	1	UTt	//기술
トップレス	탑리스	1	VCp	//의복
とっ外れ	맨 끝	1	VPl	//장소 : 
ドネルケバブ	도네르케밥	1	VFd	//음식(음료) :
トカレフ	토카레프	1	VTw	//무기 :
デンプシーロール	뎀프시롤	1	UTt	//기술
ドヤ顔	의기양양한 얼굴	1	VBp	//신체
ドライアイ	안구건조증	1	UTi	//질병 :
ドリアン	두리안	1	QAM	//과일명
トンカチ	쇠망치	1	VPe	//도구
ドングリ	도토리	1	QAM	//과일명
なに食わない顔	새침한 얼굴	1	VBp	//신체부위 :
ナットウ	낫토	1	VFd	//음식(음료) :
ナマ脚	생다리	1	VBp	//신체부위 :
ナミダ	눈물	1	VLu	//분비물
ニオイ	냄새	1	UYm	//냄새(후각)
におーい	냄새	1	UYm	//냄새(후각)
ニヤケ面	웃는 얼굴	1	VBp	//신체부위 : 
ヌーヨーク	뉴욕	1	QCTVPl	//장소, 지명 :
ネコミミ	고양이귀	1	VBp	//신체부위 : 
パーフェクトヘヴン	퍼펙트 헤븐	1	VPl	//장소 :
ハーブティ	허브티	1	VFd	//음식(음료) : 
ハイキック	하이킥	1	UTt	//기술
パイパン	백보지	1	VBp	//신체부위 : 
パイパンマンコ	백보지	1	VBp	//신체부위 : 
ハイヤー	전세 자동차	1	VTp	//교통수단
ばか面	멍청한 얼굴	1	VBp	//신체부위 :
バクダン	폭탄	1	VTw	//무기 :
バズーカ	바주카	1	VTw	//무기 :
ハタキ	먼지떨이	1	VPe	//도구
バックステップ	백스텝	1	UTt	//기술
バックドロップ	백드롭	1	UTt	//기술
バトルアックス	배틀엑스	1	VTw	//무기 :
バッテラ	고등어초밥	1	VFd	//음식(음료) :
ハンターボウ	헌터보우	1	VTw	//무기 :
ぱんつ	팬티	1	VCp	//의복
パンツー	팬티	1	VCp	//의복
パンティ	팬티	1	VCp	//의복
ハラボテ	불룩해진 배	1	VBp	//신체부위 :
ハンドガン	핸드건	1	VTw	//무기 :
フェラチオ	펠라치오	1	UTt	//기술
ひとつ部屋	한 방	1	VPl	//장소 : ひとつ部屋の中で暮らしていれば
ひじ鉄	팔꿈치치기	1	UTt	//기술
ふくれっ面	뾰로통한 얼굴	1	VBp	//신체부위 :
ブルックリン	브룩클린	1	QCTVPl	//장소, 지명 :
フルフェイスヘルメット	풀페이스 헬멧	1	VCp	//의복
ブルマー	부르마	1	VCp	//의복
ボーイッシュ	보이쉬	1	UYh	//외적 형용
へっぽこぶり	서투른 꼴	1	UYh	//외적 형용
ホットケーキ	핫 케익	1	VFd	//음식(음료) :
ボロ家	고물집	1	VPl	//장소 :
マ○コ	보지	1	VBp	//신체부위 :
マシュマロ	머시멜로우	1	VFd	//음식(음료) :
マシンガン	머신건	1	VTw	//무기 :
マゾっ気	마조끼	1	UYi	//내적 형용
マニアック	매니악	1	UYi	//내적 형용 : 
マングリ返し	굴곡위	1	UTt	//기술
まんぐり返し	굴곡위	1	UTt	//기술
まんぐりがえし	굴곡위	1	UTt	//기술
みぞおち	명치	1	VBp	//신체
ミリョク	매력	1	UYi	//내적 형용
メス穴	암컷구멍	1	VBp	//신체부위 :
ヤセがまん	오기	1	UFl	//감정
ヤセ我慢	오기	1	UFl	//감정
やせ我慢	오기	1	UFl	//감정
よがり汁	환희의 즙	1	VLu	//분비물
ヨクボウ	욕망	1	UFl	//감정
ヨダレ	군침	1	VLu	//분비물
ヨロコビ	기쁨	1	UFl	//감정
ラクガキ	낙서	1	VSp	//그림
リーダシップ	리더십	1	UYi	//내적 형용
レイピア	레이피어	1	VTw	//무기 :
ローキック	로우킥	1	UTt	//기술
ワラビモチ	고사리떡	1	VFd	//음식(음료) :
家じゅう	집안 구석구석	1	VPl	//장소 :
苛め甲斐	괴롭히는 보람	1	UFl	//감정
家ん中	집 안	1	VPl	//장소 : 
加齢臭	홀애비 냄세	1	UYm	//냄새(후각)
駕籠	가마	1	VTp	//교통수단
竿肌	음경표피	1	VBp	//신체부위 :
甘酢	감초	1	VFdVPt	//음식, 식물
降りどき	내릴 때	1	UMe	//시간 : 体調不良を訴えて教室を去る、いわば降りどきを失ったその行き着く果ては……。
開けた場所	열린 장소	1	VPl	//장소 :
鎧甲	갑옷	1	VCp	//의복
鎧兜	갑옷과 투구	1	VCp	//의복
巨乳	거유	1	VBp	//신체부위 :
居住区	거주구	1	VPl	//장소 :
怯えの表情	두려움의 표정	1	UYh	//외적 형용 :
激辛	격신[激辛]	1	UYa	//맛(미각) :
見せしめ	본보기	1	UPp	//상&벌 : 神を疑う者への見せしめとして
見せ物小屋	가설극장	1	VPl	//장소 :
肩紐	어깨끈	1	VCp	//의복
鎌首	굽은 목	1	VBp	//신체부위 : 
驚喜	뜻밖의 기쁨[驚喜]	1	UFl	//감정
尻たぶ	엉덩이살	1	VBp	//신체부위 :
尻の穴	엉덩이 구멍	1	VBp	//신체부위 :
股間	사타구니	1	VBp	//신체부위
古武術	고무술	1	UTt	//기술
古傷	오랜 상처	1	UTi	//질병 :
苦労のし甲斐	고생하는 보람	1	UFl	//감정
股奥	가랑이 속	1	VPl	//장소 :
尻肉	엉덩이살	1	VBp	//신체부위 :
股座	가랑이	1	VBp	//신체부위 :
股布部分	사타구니 부분	1	VBp	//신체부위 :
尻穴	엉덩이 구멍	1	VBp	//신체부위 :
骨張った手	앙상한 손	1	VBp	//신체 : 骨張った手で優しく彼は彼女の頬を撫でた。
骨張った指	앙상한 손가락	1	VBp	//신체 : でも硬く骨ばった指は少し痛いです。
攻めどき	공격할 때	1	UMe	//시간 : ここが攻めどきだと見て、俺はぐっと鮎美に一歩近づいていく。
串肉	꼬치고기	1	VFd	//음식(음료) :
広野	광야	1	VPl	//장소 :
怪訝顔	의아한 얼굴	1	VBp	//신체부위 :
教え甲斐	가르치는 보람	1	UFl	//감정
橋向こう	다리 건너편	1	VPl	//장소 :
口枷	입마개	1	VCp	//의복
口角	입가	1	VBp	//신체부위 :
口奥	목 안	1	VPl	//장소 :
口臭	입냄새	1	UYm	//냄새(후각)
巻き卵	계란말이	1	VFd	//음식(음료) :
巻き卵き	계란말이	1	VFd	//음식(음료) :
帰宅道	귀가길	1	VPl	//장소 :
克服術	극복술	1	UTt	//기술
近隣	근처	1	VPl	//장소 :
根暗	어두운 성격	1	UYi	//내적 형용 : 
今頃	지금쯤	1	UMe	//시간 :
二段斬り	2단 베기	1	UTt	//기술
三段撃ち	3단 사격	1	UTt	//기술
袈裟斬り	어슷 베기	1	UTt	//기술
唐竹割り	세로 베기	1	UTt	//기술
給仕服	급사복	1	VCp	// :의복
奇樹	기이한 나무	1	VPt	//식물 :
騎乗位	승마위	1	UTt	//기술
仕服	사복[仕服]	1	VCp	//의복
男子校	남학교	1	VPl	//장소 :
南皮	남피	1	QCTVPl	//장소, 지명 :
喫茶	찻집	1	VPl	//장소 :
納刀	납도[納刀]	1	VTw	//무기 :
内凶	내숭	1	UYi	//내적 형용
女肉口	여육구[女肉口]	1	VBp	//신체부위 :
女陰口	여음구[女陰口]	1	VBp	//신체부위 :
女陰門	여음문[女陰門]	1	VBp	//신체부위 :
女子校	여학교	1	VPl	//장소 :
女汁	여액[女汁]	1	VLu	//분비물
女唇	여순[女唇]	1	VBp	//신체부위 :
女穴	여자구멍	1	VBp	//신체부위 :
女花門	여화문[女肉門]	1	VBp	//신체부위 :
女花肉	여화육[女花肉]	1	VBp	//신체부위 :
女花唇	여화순[女花唇]	1	VBp	//신체부위 :
怒った顔	화난 얼굴	1	VBp	//신체부위
尿孔	오줌구멍	1	VBp	//신체부위 :
尿穴	오줌구멍	1	VBp	//신체부위 : 
茶漬け	챠즈케	1	VFd	//음식(음료) : 
当たり所	맞은 곳	1	VPl	//장소 :
大広場	대광장	1	VPl	//장소 :
大内裏	궁궐 구역	1	VPl	//장소 :
対面座位	대면좌위	1	UTt	//기술
大番	경비조직	1	VGt	//집합(군집)
大本営	대본영	1	VGt	//집합(군집)
大音響	대음향	1	UHr	//음성(음향) :
大通路	큰 통로	1	VPl	//장소 : 
大八車	큰짐수레	1	VTp	//교통수단
逃げ場所	도망갈 장소	1	VPl	//장소 :
桃尻	분홍 엉덩이	1	VBp	//신체부위 :
刀傷	도상[刀傷]	1	UTi	//질병 :
桃色	분홍색	1	UCr	//색상
桃園館	도원관	1	VPl	//장소 :
桃唇	분홍 입술	1	VBp	//신체부위 :
豚鍋	부타나베	1	VFd	//음식(음료) :
働き甲斐	일하는 보람	1	UFl	//감정
冬木立	겨울숲	1	VPl	//장소 :
同部屋	같은 방	1	VPl	//장소 :
錬成	연성	1	UTt	//기술
同室	동실[同室]	1	VPl	//장소 :
東海	동해	1	VPl	//장소 :
得意料理	자신있는 요리	1	VFd	//음식(음료) :
橙色	주황색	1	UCr	//색상
裸絞め	맨손조르기	1	UTt	//기술
来世	내세	1	VPl	//장소 :
両の眼	두 눈	1	VBp	//신체부위 :
両脚	양다리	1	VBp	//신체부위 :
両手のひら	양손바닥	1	VBp	//신체부위 :
両耳	양쪽 귀	1	VBp	//신체부위 :
両足首	양 발목	1	VBp	//신체부위 :
力瘤	알통	1	VBp	//신체부위 :
両脇	양 옆	1	VPl	//장소 :
連撃	연격	1	UTt	//기술
連射	연사	1	UTt	//기술
猟銃	엽총	1	VTw	//무기 :
路肩	갓길	1	VPl	//장소 :
頼り甲斐	부탁하는 보람	1	UFl	//감정
寮内	기숙사내	1	VPl	//장소 :
涙の粒	눈물 방울	1	VLu	//분비물
涙目	눈물고인 눈	1	VBp	//신체부위 :
裏サイト	뒷사이트	1	VPl	//장소 :
裏スジ	성기 뒷부분	1	VBp	//신체부위 :
裏拳	손등치기	1	UTt	//기술
裏筋	성기 뒷부분	1	VBp	//신체부위 :
里内裏	천황의 임시거처	1	VPl	//장소 :
裏社会	뒷사회	1	VPl	//장소 :
裏山	뒷산	1	VPl	//장소 :
隣家	이웃집	1	VPl	//장소 :
馬鹿面	멍청한 얼굴	1	VBp	//신체부위 :
馬小屋	마구간	1	VPl	//장소 :
馬場	승마장	1	VPl	//장소 :
万札	만엔권	1	VMy	//화폐
面もち	얼굴	1	VBp	//신체부위 :
眠り顔	잠든 얼굴	1	VBp	//신체부위 :
面構え	상판떼기	1	VBp	//신체부위 :
ツラ構え	상판떼기	1	VBp	//신체부위 :
蔑ろ	업신여김	1	UFl	//감정
冥土	저승	1	VPl	//장소 :
牡器	수컷성기	1	VBp	//신체부위 :
毛玉取り器	보풀제거기	1	VPe	//도구
牡欲	수컷 욕구	1	UFl	//감정
慕情	사모하는 마음	1	UFl	//감정
牡汁	수컷즙	1	VLu	//분비물
牡臭	수컷냄새	1	UYm	//냄새(후각)
目隠し	눈가리개	1	VCp	//의복
夢見心地	꿈 같은 기분	1	UYi	//내적 형용 : 
猫撫で声	간살스러운 소리	1	UHr	//음성(음향) :
無茶ぶり	터무니 없는 꼴	1	UYh	//외적 형용
猫耳	고양이귀	1	VBp	//신체부위 :
無間地獄	무간지옥	1	VPl	//장소 :
拇指	엄지손가락	1	VBp	//신체부위 :
美脚	미각[美脚]	1	VBp	//신체부위 :
美尻	아름다운 엉덩이	1	VBp	//신체부위 :
媚孔	요염한 구멍	1	VBp	//신체부위 :
米屋	쌀가게	1	VPl	//장소 :
美腰	미요[美腰]	1	VBp	//신체부위 :
美乳	미유[美乳]	1	VBp	//신체부위 :
媚肉	미육[媚肉]	1	VBp	//신체부위 :
媚粘膜	오염한 점막	1	VBp	//신체부위 :
美酒	미주[美酒]	1	VFd	//음식(음료) : 
媚穴	요염한 구멍[媚穴]	1	VBp	//신체부위 :
蜜液	밀액[蜜液]	1	VLu	//분비물
蜜肉	밀육[蜜肉]	1	VBp	//신체부위 : 
蜜汁	밀액	1	VLu	//분비물
蜜穴	밀혈[蜜穴]	1	VBp	//신체부위 :
薄桃色	엷은 분홍색	1	UCr	//색상
薄味	담백한 맛	1	UYa	//맛(미각) :
薄紅色	담홍색	1	UCr	//색상
薄黄色	엷은 황색	1	UCr	//색상
発作	발작	1	UTi	//질병
背面座位	배면좌위	1	UTt	//기술
方舟	방주	1	VTp	//교통수단
百均	100엔샵	1	VPl	//장소 :
白魔法	백마법	1	UTt	//기술
百人隊	백인대	1	VGt	//집합(군집)
白下着	흰 속옷	1	VCp	//의복
犯し甲斐	범하는 보람	1	UFl	//감정
辺鄙	외진 곳	1	VPl	//장소 : 
別腹	다른 배	1	VTp	//교통수단
別世界	이세계	1	VPl	//장소 :
並木	가로수	1	VPt	//식물 :
鴇色	연분홍색	1	UCr	//색상
腹の肉	뱃살	1	VBp	//신체부위 :
腹巻き	복대	1	VCp	//의복
腹上	배 위	1	VPl	//장소 :
腹奥	뱃속	1	VPl	//장소 :
本邸	본저[本邸]	1	VPl	//장소 :
棒ちぎり	몽둥이	1	VTw	//무기 :
棒ちぎり木	몽둥이	1	VTw	//무기 :
棒乳切り	몽둥이	1	VTw	//무기 :
付けどころ	붙일 곳	1	VPl	//장소 : 俺の目の付けどころはオッパイだけかいっ！文句の付けどころ
腐乱臭	썩은 냄새	1	UYm	//냄새(후각)
部室	부실	1	VPl	//장소 : 
憤懣	울분	1	UFl	//감정
体付き	몸매	1	UYh	//외적 형용 :
体操着	체조복	1	VCp	//의복
糞便	대변	1	VLu	//분비물
秘丘	비구[秘丘]	1	VBp	//신체부위 :
秘肌	비기[秘肌]	1	VBp	//신체부위 :
秘裂	비밀의 틈[秘裂]	1	VBp	//신체부위 :
秘所	비밀스런 장소	1	VPl	//장소 :
秘肉	비육[秘肉]	1	VBp	//신체부위 :
鼻汁	콧물	1	VLu	//분비물
秘唇	비순[秘唇]	1	VBp	//신체부위 :
秘穴	비밀스런 구멍[秘穴]	1	VBp	//신체부위 :
秘壺	비호[秘壺]	1	VBp	//신체부위 :
牝汁	암컷즙	1	VLu	//분비물
牝喘ぎ	암컷의 허덕임	1	UHr	//음성(음향) :
使い所	사용할 곳	1	VPl	//장소 :
四の字固	4자 굳히기	1	UTt	//기술
斜め上	대각선 위	1	UDr	//방향
斜め下	대각선 아래	1	UDr	//방향
斜め後ろ	대각선 뒤	1	UDr	//방향
私んち	우리집	1	VPl	//장소 :  ♞俺んち가 필터링으로 바뀜 : 俺んちが嫌なら。
私ンチ	우리집	1	VPl	//장소 :  ♞俺ンチ
お前んち	너희 집	1	VPl	//장소
お前ンチ	너희 집	1	VPl	//장소
お前ん家	너희 집	1	VPl	//장소
寺社	지사[寺社]	1	VPl	//장소 :
山高帽	중산모	1	VCp	//의복
産道	산도[産道]	1	VBp	//신체부위 :
酸味	신맛	1	UYa	//맛(미각) :
山村	산촌	1	VPl	//장소 :
商店街	상점가	1	VPl	//장소 :
森ん中	숲속	1	VPl	//장소
生足	맨다리	1	VBp	//신체부위 :
色気	색기	1	UYh	//외적 형용
色恋	색정	1	UFl	//감정
生甲斐	사는 보람	1	UFl	//감정
生歌	생가[生歌]	1	USo	//노래
生脚	생다리	1	VBp	//신체부위 :
棲家	서가[棲家]	1	VPl	//장소 :
西館	서관	1	VPl	//장소 :
善がり汁	환희의 즙	1	VLu	//분비물
先ッポ	끝 쪽	1	UDr	//방향
先っぽ	끝 쪽	1	UDr	//방향
先走りの粘液	쿠퍼점액	1	VLu	//분비물
先走りの汁	쿠퍼액	1	VLu	//분비물
先走り汁	쿠퍼액	1	VLu	//분비물
先触れ汁	쿠퍼액	1	VLu	//분비물
旋風脚	선풍각	1	UTt	//기술
舌づかい	혀 사용	1	UTt	//기술
舌遣い	혀 사용	1	UTt	//기술
舌腹	혓바닥	1	VBp	//신체부위 :
雪山	설산	1	VPl	//장소
繊指	가냘픈 손가락	1	VBp	//신체부위 :
繊手	가냘픈 손	1	VBp	//신체부위 :
聖衣	성의[聖衣]	1	VCp	//의복
城中	성 안	1	VPl	//장소 :
性臭	성취[性臭]	1	UYm	//냄새(후각)
細首	가는 목	1	VBp	//신체부위
細腰	가는 허리	1	VBp	//신체부위 : 
召し物	의복	1	VCp	//의복
小国	소국	1	VPl	//장소 :
小宮殿	소궁전	1	VPl	//장소 :
小部屋	작은 방	1	VPl	//장소 :
小山	작은 산	1	VPl	//장소 :
小傷	작은 상처	1	UTi	//질병
小細工	잔재주	1	UTt	//기술
小水	오줌	1	VLu	//분비물
掻痒感	가려운 느낌	1	URc	//지각(인지)
小太刀	코타치[小太刀]	1	VTw	//무기 :
手コキ	손 애무	1	UTt	//기술
手マン	손 애무	1	UTt	//기술
手々	손가락	1	VBp	//신체부위 : 
手枷	수갑	1	VAc	//장신구
手脚	팔다리	1	VBp	//신체부위 : 
水軍鍋	해물전골	1	VFd	//음식(음료) : 
手刀	수도	1	VTw	//무기 :
首元	목 언저리	1	VPl	//장소 :
狩場	사냥터	1	VPl	//장소 :
水責め	물고문	1	UPp	//상&벌 : 
縄張り	세력권	1	VPl	//장소 : 
市立病院	시립병원	1	VPl	//장소 :
食い物	먹을 것	1	VFd	//음식(음료) : 
獣臭	짐승냄새	1	UYm	//냄새(후각)
呻き声	신음소리	1	UHr	//음성(음향) :
息がかる距離	숨이 닿는 거리	1	UXd	//거리
身嗜み	몸가짐	1	UYh	//외적 형용 : 身嗜みのチェックを始めた。
神魔界	신마계	1	VPl	//장소 :
新幹線	신칸센	1	VTp	//교통수단
身体付き	몸매	1	UYh	//외적 형용 :
心配顔	걱정스런 얼굴	1	VBp	//신체부위 :
十分の一	10분의 1	UYr	//(비율) ちょっと前まではその十分の一くらいで買えたのに
十人隊	십인대	1	VGt	//집합(군집)
辻蹴り	낭심차기	1	UTt	//기술
辻便所	공중변소	1	VPl	//장소 :
双臀	양 엉덩이	1	VBp	//신체부위 :
双乳	양 가슴	1	VBp	//신체부위 :
我慢汁	쿠퍼액	1	VLu	//분비물
悪戯心	장난끼	1	UFl	//감정
安マンション	싸구려 맨션	1	VPl	//장소 :
岩陰	바위 그늘	1	VPl	//장소 :
昂奮	큰 흥분	1	UFl	//감정
愛蜜	애밀[愛蜜]	1	VLu	//분비물
愛汁	애액	1	VLu	//분비물
崖下	절벽 밑	1	VPl	//장소 :
腋毛	겨드랑이 털	1	VBp	//신체부위 :
桜餅	사쿠라모찌	1	VFd	//음식
桜坂	벚꽃 언덕	1	VPl	//장소 :
夜泣き	밤울음	1	UHr	//음성(음향) :
野太刀	야태도	1	VTw	//무기 :
若竹	어린 대나무	1	VPt	//식물 :
若竹煮	죽순탕	1	VFd	//음식(음료) :
若竹汁	죽순국	1	VFd	//음식(음료) :
薬指	약지	1	VBp	//신체부위 : 
痒薬	가려운 약	1	VMd	//약품
駅弁当	역에서 파는 도시락	1	VFd	//음식(음료) : 
駅前通り	역앞 길	1	VPl	//장소 : 
温野菜	익힌 야채	1	VFd	//음식(음료) : 
外れの方	변두리 쪽	1	UDr	//방향
腰の振り	허리 흔들기	1	UTt	//기술
腰づかい	허리 사용	1	UTt	//기술
憂い顔	슬픈 얼굴	1	VBp	//신체부위 : 
右肩	우측 어깨	1	VBp	//신체부위 : 
腰振り	허리 흔들기	1	UTt	//기술
右隣	오른쪽 옆	1	VPl	//장소 :
右目	오른쪽 눈	1	VBp	//신체부위 : 
優美	우미[優美]	1	UYh	//외적 형용 :
右膝	오른쪽 무릎	1	VBp	//신체부위 : 
羽織	겉옷	1	VCp	//의복
雄マラ	수컷음경	1	VBp	//신체부위 :
右頬	오른쪽 뺨	1	VBp	//신체부위 : 
右胸	오른쪽 가슴	1	VBp	//신체부위 : 
癒し系	치유계	1	UYi	//내적 형용 : 
揉み心地	주무르는 느낌	1	UYt	//촉감
柔らかおっぱい	부드러운 젖가슴	1	VBp	//신체부위 :
濡れ音	젖은 소리	1	UHr	//음성(음향) :
乳肌	가슴살	1	VBp	//신체부위 :
幽霊船	유령선	1	VTp	//교통수단
乳輪	유륜	1	VBp	//신체부위 :
油坊主	은대구	1	QAC	//어류
柔乳	유유[柔乳]	1	VBp	//신체부위 :
柔肉	유육[柔肉]	1	VBp	//신체부위 :
肉づき	살집	1	VBp	//신체부위
肉幹	육간[肉幹]	1	VBp	//신체부위 :
肉竿	육봉	1	VBp	//신체부위 :
肉胴	육봉	1	VBp	//신체부위 :
肉孔	고기구멍	1	VBp	//신체부위 :
肉壁	육벽[肉壁]	1	VBp	//신체부위 :
肉門	육문[肉門]	1	VBp	//신체부위 :
肉棒	육봉	1	VBp	//신체부위 :
肉傘	육산[肉傘]	1	VBp	//신체부위 :
肉柱	육주[肉柱]	1	VBp	//신체부위 :
肉唇	육순[肉唇]	1	VBp	//신체부위 :
肉槍	육창[肉槍]	1	VBp	//신체부위 :
肉臭	육취[肉臭]	1	UYm	//냄새(후각)
肉杭	고기말뚝	1	VBp	//신체부위 :
肉穴	고기구멍	1	VBp	//신체부위 :
肉壺	고기단지	1	VBp	//신체부위 :
潤み声	울먹이는 소리	1	UHr	//음성(음향) :
隠れ場所	숨은 장소	1	VPl	//장소 :
銀鼠色	은서색	1	UCr	//색상
乙女丼	아가씨 덮밥	1	VFd	//음식(음료) : 
淫ら腰	음란한 허리	1	VBp	//신체부위 :
淫ら汗	음란한 땀	1	VLu	//분비물
淫器具	음기구[淫器具]	1	VPe	//도구
淫裂	음렬[淫裂]	1	VBp	//신체부위 :
陰門	음문[陰門]	1	VBp	//신체부위 :
淫蜜	음밀[淫蜜]	1	VLu	//분비물
淫肉	음육[淫肉]	1	VBp	//신체부위 : 
淫音	음음[淫音]	1	UHr	//음성(음향) :
淫情	음정[淫情]	1	UFl	//감정
淫膣	음질[淫膣]	1	VBp	//신체부위 :
衣ずれ音	옷 스치는 소리	1	UHr	//음성(음향) :
衣装一式	의상 한 벌	1	VCp	//의복
依り代	기댈 곳	1	VPl	//장소 : 
二刀流	이도류	1	UTt	//기술
耳奥	귓속	1	VPl	//장소 :
耳障りな音	거슬리는 소리	1	UHr	//음성(음향) :
異臭	이취[異臭]	1	UYm	//냄새(후각)
耳擦り	귓속말	1	UHr	//음성(음향) :
一筋縄	보통 수단	1	UMn	//수단(방법,제도)
耳鼻科	이비인후과	1	VPl	//장소 :
一本背負い	한판 업어치기	1	UTt	//기술
日に焼けた顔	햇볕에 그을린 얼굴	1	VBp	//신체 : 農夫らしく日に焼けた顔と逞しい体を
日暮れ時	해질 때	1	UMe	//시간 :
日暮れ前	해지기 전	1	UMe	//시간 :
一太刀	일태도	1	VTw	//무기 :
子宮口	자궁입구	1	VPl	//장소 :
柘榴	석류	1	QAM	//과일명
子守唄	자장가	1	USo	//노래
雌欲	암컷 욕구	1	UFl	//감정
髭面	수염투성이 얼굴	1	VBp	//신체부위 :
将棋盤	장기판	1	VFn	//가구
吊り革	손잡이	1	VPe	//도구
長手袋	긴 장갑	1	VCp	//의복
赤玉	적옥[赤玉]	1	VJw	//보석
掌中	손바닥 안	1	VPl	//장소 :
長銃	장총	1	VTw	//무기 :
張形	딜도	1	VPe	//도구
裁ちばさみ	재단 가위	1	VPe	//도구
田舎道	시골길	1	VPl	//장소 :
戦衣装	전투복	1	VCp	//의복
前蹴り	앞차기	1	UTt	//기술
全身鎧	전신갑	1	VCp	//의복
店屋	가게	1	VPl	//장소 :
町工場	동네공장	1	VPl	//장소 :
釣り込み技	끌어들이는 기술	1	UTt	//기술
醍醐味	참된 맛	1	UYa	//맛(미각) :
斉射	일제사격	1	UTt	//기술
正常位	정상위	1	UTt	//기술
精液	정액	1	VLu	//분비물
鯛焼き	붕어빵	1	VFd	//음식(음료) :
朝一番	아침 일찍	1	UMe	//시간 :
早朝	이른 아침	1	UMe	//시간 :
足の筋肉	다리 근육	1	VBp	//신체부위
足の筋	다리 근육	1	VBp	//신체부위
足枷	족쇄	1	VAc	//장신구
足甲	발등	1	VBp	//신체부위 : 
縦割り	세로베기	1	UTt	//기술
左隣	왼쪽 옆	1	VPl	//장소 :
左目	왼쪽 눈	1	VBp	//신체부위 : 
左膝	왼쪽 무릎	1	VBp	//신체부위 : 
座位	좌위	1	UTt	//기술
左頬	왼쪽 뺨	1	VBp	//신체부위 : 
左胸	왼쪽 가슴	1	VBp	//신체부위 : 
呪具	주술도구	1	VPe	//도구
住処	거처	1	VPl	//장소 :
昼前	오전	1	UMe	//시간 :
肘鉄	팔꿈치치기	1	UTt	//기술
竹光	죽도	1	VTw	//무기 :
逡巡	망설임	1	UFl	//감정
重巡洋艦	중순양함	1	VTp	//교통수단
中央区	중앙구역	1	VPl	//장소 :
中原	중원	1	VPl	//장소 :
指づかい	손가락 사용	1	UTt	//기술
至近距離	지근거리	1	UXd	//거리
指南書	지도서	1	VBk	//책
枝毛	갈라진 머리카락	1	VBp	//신체부위 :
地獄絵	지옥도	1	VSp	//그림
地獄絵図	지옥도	1	VSp	//그림
只中	한복판	1	VPl	//장소 :
知恵熱	열병	1	UTi	//질병 :
姫肉門	희육문[姬肉門]	1	VBp	//신체부위 :
姫唇	희순[姬唇]	1	VBp	//신체부위 :
膣孔	질구멍[膣孔]	1	VBp	//신체부위 :
姫花肉	희화육[姬花肉]	1	VBp	//신체부위 :
塵取	쓰레받이	1	VPe	//도구
膣奥	질 안쪽	1	UDr	//방향
膣肉	질육[膣肉]	1	VBp	//신체부위 :
膣穴	질 구멍	1	VBp	//신체부위 :
膣壷	질단지[膣壺]	1	VBp	//신체부위 :
澄之江	스미노에	1	QCTVBl	//지명,장소
着物	기모노	1	VCp	//의복
擦れ枯し	닳고 닳음	1	UYi	//내적 형용 : 
擦れ枯らし	닳고 닳음	1	UYi	//내적 형용 : 
斬機刀	참기도	1	VTw	//무기 :
喘ぎ声	허덕이는 소리	1	UHr	//음성(음향) :
菖蒲	창포[菖蒲]	1	VPt	//식물이름. 붓꽃. 사람 이름이기도 하다 (아야메)
千人隊	천인대	1	VGt	//집합(군집)
天津	텐진	1	QCTVPl	//장소, 지명 :
睫毛	속눈썹	1	VBp	//신체부위 : 
蒼海	창해[蒼海]	1	VPl	//장소 :
躰中	신체 안	1	VPl	//장소 :
草の蔓	풀의 덩굴	1	VPt	//식물 :
触り心地	만지는 느낌	1	UYt	//촉감
摘まみ心地	붙잡는 느낌	1	UYt	//촉감
寸での所	위기의 순간	1	UMe	//시간 :
惣菜	나물	1	VFd	//음식
総菜	나물	1	VFd	//음식
最高位	최고위	1	UXg	//위치고저
最上位	최상위	1	UXg	//위치고저
最弱	최약	1	UYs	//강도
最下位	최하위	1	UXg	//위치고저
抽斗	서랍	1	VFn	//가구
軸足	디딤발	1	VBp	//신체부위 :
春頃	봄경	1	UMe	//시간 :
出かけ際	나갈 때	1	UMe	//시간 :
恥蜜	치밀[恥蜜]	1	VLu	//분비물
側位	측위	1	UTt	//기술
親子丼	오야코동	1	VFd	//음식(음료) :
恥肉	치육[恥肉]	1	VBp	//신체부위 :
置き場所	보관장소	1	VPl	//장소 :
他所	다른 장소	1	VPl	//장소 :
脱衣所	탈의실	1	VPl	//장소 : 
湯屋	공중목욕탕	1	VPl	//장소 :
台車	손수레	1	VTp	//교통수단
太腿	허벅지	1	VBp	//신체부위 :
卓袱台	밥상	1	VFn	//가구
唄声	노랫소리	1	UHr	//음성(음향) :
平手打ち	손바닥 치기	1	UTt	//기술
夏木立	여름숲	1	VPl	//장소 :
咆哮	포효	1	UHr	//음성(음향) :
夏バテ	더위먹음	1	UTi	//질병 :
被服室	의상실	1	VPl	//장소 :
片脚	한쪽 다리	1	VBp	//신체부위 : 
下腹の奥	아랫배 속	1	VPl	//장소 :
何食わない顔	시치미 뗀 얼굴	1	VBp	//신체부위 :
下乳	아랫가슴	1	VBp	//신체부위 : 
下穿き	속옷	1	VCp	//의복
下駄箱	신발장	1	VFn	//가구
学園前	학원 앞	1	VPl	//장소 :
学園中	학원 중	1	VPl	//장소 :
汗の粒	땀방울	1	VLu	//분비물
割り箸	젓가락	1	VPe	//도구
海原	해원	1	VPl	//장소 :
肛穴	항문	1	VBp	//신체부위 :
行き際	갈 때	1	UMe	//시간 :
肛腔	항강[肛腔]	1	VBp	//신체부위 :
汗粒	땀방울	1	VLu	//분비물
革鎧	가죽갑옷	1	VCp	//의복
革着	가죽옷	1	VCp	//의복
穴口	구멍입구	1	VPl	//장소 :
穴奥	구멍 속	1	VPl	//장소 :
頬の肉	볼살	1	VBp	//신체부위 : 
狐耳	여우귀	1	VBp	//신체부위 : 
頬肉	볼살	1	VBp	//신체부위 : 
湖畔	호숫가	1	VPl	//장소 :
荊州	형주	1	QCTVPl	//장소, 지명 :
花の蕾	꽃봉오리	1	VPt	//식물
紅花	붉은 꽃	1	VPt	//식물 :
和み系	온화계	1	UYi	//내적 형용 : 
和歌	와카[和歌]	1	USo	//노래
和傘	일본우산	1	VPe	//도구
花香	꽃향기	1	UYm	//냄새(후각)
靴箱	신발상자	1	VFn	//가구
幻想郷	환상향	1	VPl	//장소 :
黄金郷	황금향	1	VPl	//장소 :
回廊	회랑	1	VPl	//장소 :
回し蹴り	돌려차기	1	UTt	//기술
懐中電灯	손전등	1	VPe	//도구
朽木	썩은 나무	1	VPt	//식물 :
後背位	후배위	1	UTt	//기술
後背座位	배후좌위	1	UTt	//기술
喉奥	목 안	1	VPl	//장소 :
胸鎧	흉갑	1	VCp	//의복
胸肌	가슴살갗	1	VBp	//신체부위 :
胸当て	흉갑	1	VCp	//의복
黒板消し	칠판지우개	1	VPe	//도구
胸奥	가슴 속	1	VPl	//장소 :
蛇の目	뱀의 눈	1	VBp	//신체부위 : 
仏頂面	시무룩한 얼굴	1	VBp	//신체부위 : 
偽善者面	위선자 얼굴	1	VBp	//신체부위 : 
シモジモ	하층민	1	VGt	//집합(군집)
塩田	염전	1	VPl	//장소 :
七星祭	칠성제	1	UCl	//종교행위(수단)
海棲生物館	해저생물관	1	VPl	//장소 :
朝餉	아침 식사	1	VFd	//음식(음료) : 
夕餉	저녁 식사	1	VFd	//음식(음료) : 
桜花	벚꽃	1	QAL	//꽃이름(풀이름)
ヤキモチ	질투	1	UFl	//감정
ヤキイモ	군고구마	1	VFd	//음식(음료) : 
あいすくりーむ	아이스크림	1	VFd	//음식(음료) : 
肌身	몸	1	VBp	//신체부위 : 
アースプライヤー	어스 플라이어	1	VPe	//도구
笹屋	오두막집	1	VPl	//장소 :
ツッコミどころ	츳코미할 곳	1	VPl	//장소 : 意外と個性があったりツッコミどころがあったりして面白いものなんですよ
先輩ん家	선배네 집	1	VPl	//장소 :
アホヅラ	바보 얼굴	1	VBp	//신체부위 : 
いもきんつば	이모킨츠바	1	VFd	//음식(음료) : 
猫口	고양이입	1	VBp	//신체부위 : 
ちっぱい	작은 가슴	1	VBp	//신체부위 : 
伸ばした足	뻗은 다리	1	VBp	//신체부위 : 
伸ばした手	뻗은 손	1	VBp	//신체부위 : 
インフェルノ	인페르노	1	VPl	//장소 :
垂れ乳	늘어진 젖	1	VBp	//신체부위 : 
オホーツク	오호츠크	1	VPl	//장소 :
共同施設	공동시설	1	VPl	//장소 :
助け舟	구조선	1	VTp	//교통수단
たぬきそば	다누키 소바	1	VFd	//음식(음료) : 
警備砦	경비 요새	1	VPl	//장소 :
ちんこ	고추	1	VBp	//신체부위 : 
シロツメクサ	토끼풀	1	VPt	//식물 :
白詰草	토끼풀	1	VPt	//식물 :
焼き鮭	연어구이	1	VFd	//음식(음료) : 
大判焼き	오방떡	1	VFd	//음식(음료) : 
不機嫌	불쾌함	1	UFl	//감정 : どうやら昨日の不機嫌を引きずっているようだ。
ふかしイモ	찐 고구마	1	VFd	//음식(음료) : 
ファンファーレ	팡파레	1	UHr	//음성(음향) :
ポン酢	퐁즈	1	VFd	//음식(음료) : 
野菜炒め	야채볶음	1	VFd	//음식(음료) : 俺は野菜炒めでも作るか…
キュウリの浅漬け	오이절임	1	VFd	//음식(음료) : 
煎餅	전병	1	VFd	//음식(음료) : 
ほうじ茶	호지차[ほうじ茶]	1	VFd	//음식(음료) : 
樹の下	나무 아래	1	VPl	//장소 :
めんつゆ	멘쯔유	1	VFd	//음식(음료) : 
ラム酒	럼주	1	VFd	//음식(음료) : 
めんたいこ	명란젓	1	VFd	//음식(음료) : 
マンガリッツァ	만갈리차	1	VFd	//음식(음료) : 
ひげ面	수염 많은 얼굴	1	VBp	//신체부위 : 
カツ丼	카츠동	1	VFd	//음식(음료) : 
栗の花	밤꽃	1	QAL	//꽃이름(풀이름)
足の指	발가락	1	VBp	//신체부위 : 
振袖	후리소데[振袖	1	VCp	//의복
冬虫夏草	동충하초	1	VPt	//식물 :
お花畑	꽃밭	1	VPl	//장소 :
ジュネーヴ	제네바	1	QCT	//도시(지명)명
学び舎	학교	1	VPl	//장소 :
一筋の汁	한줄기 즙	1	VLq	//액체
湯船のヘリ	욕조 가장자리	1	VPl	//장소 :
ユーウツ	우울	1	UFl	//감정
ガラパゴス	갈라파고스	1	QCT	//도시(지명)명
揺り椅子	흔들의자	1	VFn	//가구
ましろうどん	마시로 우동	1	VFd	//음식(음료) : 
少し回った時間	조금 지난 시간	1	UMe	//시간 :
枯芝	마른 잔디	1	VPt	//식물 :
赤面症	안면홍조증	1	UTi	//질병 :
焼き餅	구운 떡	1	VFd	//음식(음료) : 
晩ごはん	저녁밥	1	VFd	//음식(음료) : 
夜の森	밤의 숲	1	VPl	//장소 :
ほうけた顔	얼빠진 얼굴	1	VFd	//음식(음료) : 
唸り声	신음소리	1	UHr	//음성(음향) :
ねこじゃらし	강아지풀	1	VPt	//식물 : 箱の脇にねこじゃらしがあるじゃないか
全部の部屋	모든 방	1	VPl	//장소 :
エビフライ	새우튀김	1	VPl	//장소 :
ガーリック	갈릭	1	VFd	//음식(음료) : 
燃えた目	불탄 눈	1	VBp	//신체부위 : 
良がり声	교성	1	UHr	//음성(음향) :
善がり声	교성	1	UHr	//음성(음향) :
だいいんしん	대음순	1	VBp	//신체부위 : 
よがり声	교성	1	UHr	//음성(음향) :
使いどころ	사용하는 곳	1	VPl	//장소 : 使いどころ間違ってるよ。
ここらへん	이 근처	1	VPl	//(장소)
ここら辺	이 근처	1	VPl	//(장소)
熟れ鮨	나레즈시	1	VFd	//음식(음료) : 
なれ鮨	나레즈시	1	VFd	//음식(음료) : 
道ばた	도로변	1	VPl	//(장소)
カレー味	카레맛	1	UYa	//맛(미각) :
ネギトロ丼	네기토로동	1	VFd	//음식(음료) : 
かんげき	감격	1	UFl	//감정 : 感激
チーズ味	치즈맛	1	UYa	//맛(미각) :
したっぱ	아랫쪽	1	UDr	//방향
生姜焼き	생강구이	1	VFd	//음식(음료) :
蒸し料理	찜요리	1	VFd	//음식(음료) : 
神木	신목[神木]	1	VPt	//식물 :
兎小屋	토끼장	1	VPl	//장소 :
トンコツ	돈코츠	1	VFd	//음식(음료) : 
おうどん	우동	1	VFd	//음식(음료) : 
浅漬け	야채절임	1	VFd	//음식(음료) : 
猫缶	고양이 통조림	1	VFd	//음식(음료) :
煮込み料理	삶은 요리	1	VFd	//음식(음료) :
飛び道具	원거리 무기	1	VTw	//무기 :
村中	마을 안	1	VPl	//장소 :
飛び方	나는 방법	1	UTt	//기술 : わたしに飛び方を
沈んだ顔	침울한 얼굴	1	VBp	//신체부위 : 
訓練所	훈련소	1	VPl	//장소 :
世界樹	세계수	1	VPt	//식물 :
卵かけご飯	계란덮밥	1	VFd	//음식(음료) : 
被害者面	피해자 얼굴	1	VBp	//신체부위 : 
安アパート	임대 아파트	1	VPl	//장소 :
掃き溜め	쓰레기터	1	VPl	//장소 :
背すじ	등줄기	1	VBp	//신체부위 : 
痛車	이타샤[痛車]	1	VTp	//교통수단
リニアモーターカー	자기부상열차	1	VTp	//교통수단
金床	모루	1	VPe	//도구
毒入りリンゴ	독이든 사과	1	QAM	//과일명
ネツアイ	열애	1	UFl	//감정
わめき声	아우성	1	UHr	//음성(음향) :
炊きたて	갓 만든 밥	1	VFd	//음식(음료) : 
足コキ	풋잡	1	UTt	//기술
肉じゃが	고기감자조림	1	VFd	//음식(음료) : 伊月の肉じゃがに舌鼓を打ったのだった。
鶏肉じゃが	닭고기감자조림	1	VFd	//음식(음료)
肉ジャガ	고기감자조림	1	VFd	//음식(음료) : 伊月の肉じゃがに舌鼓を打ったのだった。
フトモモ	허벅지	1	VBp	//신체부위 : 
あやめ園	붓꽃원	1	VPl	//장소 :
一部屋	하나의 방	1	VPl	//장소 :
すました顔	시치미뗀 얼굴	1	VBp	//신체부위 : 
大鎌	큰 낫	1	VPe	//도구
這々の体	기진맥진한 몸	1	VBp	//신체부위 : 
服の替え	갈아입을 옷	1	VCp	//의복 : 服の替えは用意しておくように
昼めし	점심	1	VFd	//음식(음료)
おとなり	이웃	1	VPl	//장소 : おとなりのお父さんとお母さんは、
コンビーフ	콘비프	1	VFd	//음식(음료)
私んとこ	나의 곳	1	VPl	//장소 : ♞ 俺んとこはあんまりなくってさ……
金平糖	별사탕	1	VFd	//음식(음료)
忘れ物癖	건망증	1	UTi	//질병
片眼	편안[片眼]	1	VBp	//신체부위 : 
朝飯	아침밥	1	VFd	//음식(음료)
何刻	몇 시각	1	UMe	//시간
かけ声	기합소리	1	UHr	//음성(음향)
教会跡	교회자취	1	VPl	//장소
海鮮鍋	해물찌개	1	VFd	//음식(음료)
透る声	들리는 소리	1	UHr	//음성(음향)
ウィンナソーセージ	비엔나 소세지	1	VFd	//음식(음료)
もんじゃ焼き	몬자야키	1	VFd	//음식(음료)
音無き音	소리 없는 소리	1	UHr	//음성(음향)
ママレード	마멀레이드	1	VFd	//음식(음료)
柏餅	카시와모찌	1	VFd	//음식(음료)
みたらし団子	미타라시 당고	1	VFd	//음식(음료)
角煮	카쿠만	1	VFd	//음식(음료)
ムラサキ色	보라색	1	UCr	//색상
エロ本たち	애로책들	1	VBk	//책(도서)
霞草	안개꽃	1	QAL	//꽃이름(풀이름)
バルムンク	발뭉	1	VTw	//무기 : 『ニーベルンゲンの歌』に登場する剣。
ヘヴン	헤븐	1	VPl	//장소
キリマンジャロ	킬리만자로	1	QCT	//도시(지명)명
キーマカレー	소고기 카레	1	VFd	//음식(음료)
炒物	볶음	1	VFd	//음식(음료)
晴れ舞台	화려한 무대	1	VPl	//장소
蜜豆	미츠마메	1	VFd	//음식(음료)
煮魚	생선조림	1	VFd	//음식(음료)
モンゴル	몽골	1	VPl	//장소, 지명 :
揚げ魚	생선튀김	1	VFd	//음식(음료)
煮凝り	생선조림	1	VFd	//음식(음료)
煮凝	생선조림	1	VFd	//음식(음료)
煮こごり	생선조림	1	VFd	//음식(음료)
スムージー	스무디	1	VFd	//음식(음료)
ばら寿司	바라즈시	1	VFd	//음식(음료)
小籠包	샤오롱바오	1	VFd	//음식(음료)
豚の角煮	돼지고기 조림	1	VFd	//음식(음료)
利き腕	잘 쓰는 손	1	VBp	//신체부위
辣韮	락교	1	VFd	//음식(음료)
房中術	방중술	1	UTt	//기술
姉妹丼	자매덮밥	1	VFd	//음식(음료)
母女丼	모녀덮밥	1	VFd	//음식(음료)
似顔絵	초상화	1	VSp	//그림 : おもしろ半分に似顔絵をかく
棚からぼた餅	굴러들어온 떡	1	VFd	//음식(음료)
棚ボタ	굴러들어온 떡	1	VFd	//음식(음료)
棚ぼた	굴러들어온 떡	1	VFd	//음식(음료) : 棚ぼたっつーか。
和歌山	와카야마	1	VPl	//장소
レディースコミック	레이디스 코믹	1	VBk	//책(도서)
平安京	헤이안쿄	1	VPl	//장소
カルパッチョ	카르파초	1	VFd	//음식(음료)
櫻の園	벚꽃 동산	1	VPl	//장소
カップやきそば	컵 야키소바	1	VFd	//음식(음료)
炒飯	볶음밥	1	VFd	//음식(음료)
干魚	건어	1	VFd	//음식(음료)
ペチャパイ	절벽가슴	1	VBp	//신체부위
干し魚	건어	1	VFd	//음식(음료)
乾し魚	건어	1	VFd	//음식(음료)
ペチャパイッ	절벽가슴	1	VBp	//신체부위
海鮮	해산물	1	VFd	//음식(음료)
羽ばたき音	날개짓 소리	1	UHr	//음성(음향)
坦々麺	탄탄면	1	VFd	//음식(음료)
君が代	키미가요	1	USo	//노래
コンペイトウ	별사탕	1	VFd	//음식(음료)
袋ラーメン	봉지 라면	1	VFd	//음식(음료)
冷やし中華	비빔면	1	VFd	//음식(음료)
こんぺいとう	별사탕	1	VFd	//음식(음료)
花鳥盛り	화조담기	1	VFd	//음식(음료)
天丼	튀김덮밥	1	VFd	//음식(음료)
コンペイとう	별사탕	1	VFd	//음식(음료)
肩先	어깻죽지	1	VBp	//신체부위
杏仁豆腐	행인두부	1	VFd	//음식(음료)
ジンクホワイト	징크 화이트	1	UCr	//색상
白みそ	백된장	1	VFd	//음식(음료)
ビーフシチュ	비프 스튜	1	VFd	//음식(음료)
三号棟	3호동	1	VPl	//장소
北京ダッグ	북경 오리	1	VFd	//음식(음료)
デルフィニウム	델피늄	1	VPt	//식물
カトレア	카틀레야	1	VPt	//식물
​ムーンフラワー	문플라워	1	VPt	//식물
恨み節	원망	1	UFl	//감정
返り血	튀어나온 피	1	VLq	//액체 : 返り血を浴びていない
北京ダック	북경오리	1	VFd	//음식(음료)
ペドフィリア	페도필리아	1	UTi	//질병
手裏剣	수리검	1	VTw	//무기
トランキライザー	트랭퀼라이저	1	VMd	//약품
箱舟	방주	1	VTp	//교통수단
キャラメルラテ	캬라멜라떼	1	VFd	//음식(음료)
ジュラルミン	두랄루민	1	VMa	//소재
昆布巻き	다시마 말이	1	VFd	//음식(음료)
巻き寿司	마키즈시	1	VFd	//음식(음료)
カタクリ	얼레지	1	VPt	//식물
乾燥わかめ	마른 미역	1	VFd	//음식(음료)
エキシビジョン	엑시비션	1	VPl	//장소
砂利道	자갈길	1	VPl	//장소
ホンオ・フェ	홍어회	1	VFd	//음식(음료)
黄昏時	해질녘	1	UMe	//시간
メディカルセンター	메디컬 센터	1	VPl	//장소
寝屋	침실	1	VPl	//장소
寝屋川	네야가와	1	QCT	//도시(지명)명
煮込みハンバーグ	햄버그 스테이크	1	VFd	//음식(음료)
焼き菓子	구운 과자	1	VFd	//음식(음료)
合い挽き肉	저민 고기	1	VFd	//음식(음료)
お小遣い帳	용돈 출납장	1	VBk	//책(도서)
焼きたてパン	갓 구운 빵	1	VFd	//음식(음료)
育ち盛り	한창 자랄 때	1	UMe	//시간
育ちざかり	한창 자랄 때	1	UMe	//시간
待ちあわせ場所	약속 장소	1	VPl	//장소
片ひじ	한쪽 팔꿈치	1	VBp	//신체부위
片肘	한쪽 팔꿈치	1	VBp	//신체부위
ミートローフ	미트로프	1	VFd	//음식(음료)
かき揚げ	카키아게	1	VFd	//음식(음료)
お昼過ぎ	오후	1	UMe	//시간 : またお昼過ぎに目が覚めた。
濃緑色	진녹색	1	UCr	//색상
抗うつ薬	항우울제	1	VMd	//약품
お米の飯	쌀밥	1	VFd	//음식(음료)
ふかひれ	상어 지느러미	1	VFd	//음식(음료) : ふかひれスープ
お菓子類	과자류	1	VFd	//음식(음료)
きんぴらゴボウ	우엉 조림	1	VFd	//음식(음료) : 
底無し沼	바닥 없는 늪	1	VPl	//장소
長机	긴 책상	1	VFn	//가구
竹林	대나무숲	1	VPl	//장소
芋飴	고구마엿	1	VFd	//음식(음료)
ガトリングガン	개틀링건	1	VTw	//무기
刀子	작은 칼[刀子]	1	VTw	//무기
小村	작은 마을	1	VPl	//장소
血沼	피의 늪	1	VPl	//장소
右肘	오른쪽 팔꿈치	1	VBp	//신체부위
左肘	왼쪽 팔꿈치	1	VBp	//신체부위
大長刀	대장도	1	VTw	//무기
生まんこ	생보지	1	VBp	//신체부위
大坂城	오사카성	1	VPl	//장소
軋み音	삐걱거리는 소리	1	UHr	//음성(음향)
誰そ彼	황혼	1	UMe	//시간
落丁本	낙적본[[落丁]	1	VBk	//책
出羽三山	데와3산	1	VPl	//장소
皮剥き機	껍질 벗기는 기계	1	VEl	//전기기구
マーシャルアーツ	마셜 아츠	1	UTt	//기술
誰そ彼時	황혼기	1	UMe	//시간
おだんご	경단	1	VFd	//음식(음료)
嘘偽り	거짓	1	UTh	//생각(사고) : 嘘偽りのない言葉。
孕み腹	임신한 배	1	VBp	//신체부위
幻術	환술	1	UTt	//기술
筆舌	필설	1	UTs	//발화(언어수단) : 筆舌に尽くしがたい
そばやうどん	소바나 우동	1	VFd	// :음식(음료)
かつやくきん	괄약근	1	VBp	//신체부위
たまごかけご飯	달걀덮밥	1	VFd	// :음식(음료)
魔道具	마도구	1	VPe	//도구
影縫い	그림자꿰기	1	UTt	//기술
黒づくめ	검은 옷	1	VCp	//의복
湾刀	곡도	1	VTw	// :무기
手甲鉤	수갑구	1
思案顔	생각에 잠긴 얼굴	1	VBp	//신체부위
発勁	발경	1	UTt	//기술
見慣れない顔	낯선 얼굴	1	VBp	//신체부위
佩刀	패도	1	VTw	// :무기
忍装束	닌자옷	1	VCp	// :의복
女郎屋	갈봇집	1	VPl	// :장소
癒しの術	치유술	1	UTt	//기술
ひつまぶし	장어덮밥	1	VFd	// :음식(음료)
身体の筋	등골	1	VBp	//신체부위
片頬	한쪽 볼	1	VBp	//신체부위
坊主頭	스님머리	1	VBp	//신체부위
卵かけごはん	날달걀밥	1	VFd	// :음식(음료)
殺人術	살인술	1	UTt	//기술
ばんそこう	반창고	1	VPe	//도구
ゴマ和え	깨소금 무침	1	VFd	// :음식(음료)
水まんじゅう	물 만쥬	1	VFd	// :음식(음료)
笹の葉	조릿대 잎	1	VPt	// :식물
笹の葉鰈	가자미말림	1	VFd	// :음식(음료)
ブルーアイズ	블루 아이즈	1	VBp	//신체부위
連続技	연속기	1	UTt	//기술
ぬか漬け	누카즈케	1	VFd	// :음식(음료)
治癒術	치유술	1	UTt	//기술
下っぱ	밑바닥	1	UDr	// :방향
夕暮れ時	해질녘	1	UMe	// :시간
甘味処	전통다과점	1	VPl	// :장소
実銃	실총	1	VTw	// :무기
ミルクティ	밀크티	1	VFd	// :음식(음료)
大居室	접견실	1	VPl	// :장소
ポートワイン	포트 와인	1	VFd	// :음식(음료)
卵型	달걀형	1	UYh	// :인간&동물 외적 형용
リブロース	리브 로스	1	VFd	// :음식(음료)
矢倉	망루	1	VPl	// :장소
石切場	채석장	1	VPl	// :장소
長耳	긴 귀	1	VBp	//신체부위
湾岸	만안[灣岸]	1	VPl	// :장소
なまくら	무딘 칼	1	VTw	// :무기
居反り	뒤집기	1	UTt	//기술
内もも	허벅지	1	VBp	//신체부위
細身の剣	얇은 검	1	VTw	// :무기
細身剣	얇은 검	1	VTw	// :무기
北地区	북쪽 지구	1	VPl	// :장소
南地区	남쪽 지구	1	VPl	// :장소
西地区	서쪽 지구	1	VPl	// :장소
とば口	입구	1	VPl	// :장소
投斧	던지는 도끼	1	VTw	// :무기
手斧	손도끼	1	VTw	// :무기
血溜まり	피웅덩이	1	VPl	// :장소
戦鎚	워 해머	1	VTw	// :무기
稼ぎ時	돈벌 때	1	UMe	// :시간
デカちん	왕자지	1	VBp	//신체부위
デカおちんちん	왕자지	1	VBp	//신체부위♞
十徳刀	맥가이버칼	1	VTw	// :무기	//스위스 군용칼
草葉の陰	저 세상	1	VPl	// :장소
大神殿	대신전	1	VPl	// :장소
まんじう	만쥬	1	VFd	// :음식(음료)
金の鎧	금색 갑옷	1	VCp :의복
ひざ掛け	무릎 덮개	1	VPe	// :도구
つけまつげ	인조 속눈썹	1	VAc	// :장신구
魔法術	마법술	1	UTt	//기술
指貫	골무	1	VPe	// :도구
スカート丈	스커트 기장	1	UYl	// :길이
スカートの丈	스커트 길이	1	UYl	// :길이
金縛りの術	속박의 술	1	UTt	// :기술
魔銃	마총	1	VTw	// :무기
移民船	이민선	1	VTp	// :교통수단
左前方	좌전방	1	UDr	// :방향
右前方	우전방	1	UDr	// :방향
おたふく風邪	볼거리	1	UTi	// :질병
弩砲	쇠뇌포	1	VTw	// :무기
監視砦	감시요새	1	VPl	// :장소
治療術	치료술	1	UTt	// :기술
痩身法	살 빼는 법	1	UTt	// :기술
物作り	제작	1	UTt	// :기술　物作りを依頼されて
搦め手	뒷문[℡익め手]	1	VPl	// :장소
操銃	조총	1	VTw	// :무기
人食い植物	식인 식물	1	VPt	// :식물
巣穴	소굴	1	VPl	// :장소
天井裏	지붕 밑	1	VPl	// :장소
卵肌	뽀얀 피부	1	VBp	// :신체부위
炒め料理	볶음 요리	1	VFd	// :음식(음료)
吹き矢	침봉	1	VTw	// :무기
丁字路	삼거리	1	VPl	// :장소
箪笥	장롱	1	VFn	// :가구
ひと時	한때	1	UMe	// :시간	//ささやかなひと時といいますか
学生会	학생회	1	VPl	// :장소	//学生会って
道着	도복	1	VCp	// :의복
ほったて小屋	판잣집	1	VPl	// :장소
飴細工	설탕 공예	1	UTt	// :기술
質店	전당포	1	VPl	// :장소
善哉	단팥죽	1	VFd	// :음식(음료)
塩蒸し	소금찜	1	VFd	// :음식(음료)
冷やし麺	냉면	1	VFd	// :음식(음료)
得意気	득의양양	1	UYi	// :인간&동물 내적 형용
魔界	마계	1	VPl	// :장소
生け簀	활어조	1	VPl	// :장소
いちご味	딸기맛	1	UYa	// :맛(미각)
手稿	원고	1	VBk	// :책
封印術	봉인술	1	UTt	// :기술
コミュ障	소통장애	1	UTi	// :질병
さわり方	만지는 방법	1	UTt	// :기술
大空洞	큰 동굴	1	VPl	// :장소
マスケット銃	머스킷 총	1	VTw	// :무기
袈裟切り	어슷 베기	1	UTt	// :기술
干し柿	곶감	1	VFd	// :음식(음료)
居合い	거합	1	UTt	// :기술
関節技	관절기	1	UTt	// :기술
南西方向	남서 방향	1	UDr	// :방향
南外壁	남쪽 외벽	1	VPl	// :장소
断崖絶壁	단애절벽	1	VPl	// :장소
大部隊	대부대	1	VGt	// :집합(군집)
大穴	큰 구멍	1	VPl	// :장소
跳び蹴り	날아차기	1	UTt	// :기술
刀身	도신	1	VPl	// :장소
冷やしうどん	냉우동	1	VFd	// :음식(음료)
練習着	연습복	1	VCp	// :의복
路地裏	뒷골목	1	VPl	// :장소
篭手	갑옷 토시	1	VCp	// :의복
目覚めの時	눈을 뜰 때	1	UMe	// :시간
目ざめの時	눈을 뜰 때	1	UMe	// :시간
目覚めの時間	눈을 뜰 시간	1	UMe	// :시간
目ざめの時間	눈을 뜰 시간	1	UMe	// :시간
防寒着	방한복	1	VCp	// :의복
本城	본성	1	VPl	// :장소
西端	서단	1	VPl	// :장소
西門	서문	1	VPl	// :장소
先走り液	쿠퍼액	1	VLu	// :분비물
星詠み	점성술	1	UTt	// :기술
焼きソバ	야키소바	1	VFd	// :음식(음료)
小刀	코다치	1	VTw	// :무기
手配書	수배서	1	VBk	// :책
時計回り	시계 방향	1	UDr	// :방향
新撰組	신선조	1	VGt	// :집합(군집)
外縁	외곽	1	VPl	// :장소
宇治金時	팥빙수	1	VFd	// :음식(음료)
陰陽術	음양술	1	UTt	// :기술
日暮	저녁 때	1	UMe	// :시간
子葉	떡잎	1	VPt	// :식물
鏑矢	적시[鏑矢]	1	VTw	// :무기
精霊術	정령술	1	UTt	// :기술
中央地区	중앙지구	1	VPl	// :장소
中央通り	중앙대로	1	VPl	// :장소
持ち芸	개인기	1	UTt	// :기술
斬り込み隊	돌격대	1	VGt	// :집합(군집)
吹きだまり	잡동사니 더미	1	VPl	// :장소
吹き溜まり	잡동사니 더미	1	VPl	// :장소
捕縛術	포박술	1	UTt	// :기술
避来矢	화살막이	1	VCp	// :의복
必殺技	필살기	1	UTt	// :기술
海老天	새우튀김	1	VFd	// :음식(음료)
海老天ぷら	새우튀김	1	VFd	// :음식(음료)
海老天重	새우덮밥	1	VFd	// :음식(음료)
忍法	인법	1	UTt	// :기술
狐蕎麦	메밀유부 소바	1	VFd	// :음식(음료)
賄い料理	군밥 요리	1	VFd	// :음식(음료)
黒服	검은 옷	1	VCp	// :의복
リボルバー	리볼버	1	VTw	// :무기
揚げぱん	튀김빵	1	VFd	// :음식(음료)
ひと口大	한 입 크기	1	UXb	// :대소(크기, 규모)
頭ん中	머릿속	1	VPl	// :장소
栗ごはん	밤밥	1	VFd	// :음식(음료)
合挽肉	저민 고기	1	VFd	// :음식(음료)
しめじ	송이버섯	1	VPt	// :식물
平茸	느타리버섯	1	VPt	// :식물
昔とった杵柄	예전에 익힌 솜씨	1	UTt	// :기술
鳥かご	새장	1	VPl	// :장소
梅肉	매실과육	1	VFd	// :음식(음료)
三頭筋	삼두근	1	VBp	// :신체부위
梅こぶ茶	매실다시마차	1	VFd	// :음식(음료)
冷や汁	냉국	1	VFd	// :음식(음료)
西京焼き	사이쿄야키	1	VFd	// :음식(음료)
ふんどし	훈도시	1	VCp	// :의복
草鞋	짚신	1	VCp	// :의복
タコ焼き	타코야키	1	VFd	// :음식(음료)
薄焼き卵	달걀부침	1	VFd	// :음식(음료)
仕様書	사양서	1	VBk	// :책
運河通り	운하거리	1	VPl	// :장소
大水槽	대수조	1	VPl	// :장소
架け橋	가교	1	VPl	// :장소
大水族館	대수족관	1	VPl	// :장소
青藍色	청남색	1	UCr	// :색상
大宮殿	대궁전	1	VPl	// :장소
釣り船	낚싯배	1	VTp	// :교통수단
三輪駅	미와역	1	VPl	// :장소
チェリーブロッサム	체리블로섬	1	VPt	// :식물
魔法のほうき	마법의 빗자루	1	VPe	// :도구
大砂漠	대사막	1	VPl	// :장소
芋畑	감자밭	1	VPl	// :장소
栗ようかん	밤양갱	1	VFd	// :음식(음료)
炙りチーズ	구운 치즈	1	VFd	// :음식(음료)
ジパング	지팡구	1	VPl	// :장소
背脂	등 지방	1	VBp	// :신체부위
巫女術	무녀술	1	UTt	// :기술
バゲット	바게트	1	VFd	// :음식(음료)
高架下	고가 아래	1	VPl	// :장소
幻影拳	환영권	1	UTt	// :기술
西京漬け	사이쿄절임	1	VFd	// :음식(음료)
根野菜	뿌리채소	1	VPt	// :식물
巣箱	새집	1	VPl	// :장소
棒編み	대바늘뜨기	1	UTt	// :기술
かぎ針編み	코바늘뜨기	1	UTt	// :기술
鉤針編み	코바늘뜨기	1	UTt	// :기술
残像拳	잔상권	1	UTt	// :기술
鍋底	냄비 바닥	1	VPl	// :장소
味塩	맛소금	1	VFd	// :음식(음료)
鉄山靠	철산고	1	UTt	// :기술
らーめん	라-면	1	VFd	// :음식(음료)
箱船	방주	1	VTp	// :교통수단
アシ代	교통비	1	UYp	// :가격고저
もち米	찹쌀	1	VFd	// :음식(음료)
糯米	찹쌀	1	VFd	// :음식(음료)
餅米	찹쌀	1	VFd	// :음식(음료)
厨二力	중2력	1	UYs	// :강도
厨二病	중2병	1	UTi	// :질병
藤の花	등꽃	1	QAL	// :꽃이름(풀이름)
引きどころ	당기는 곳	1	VPl	// :장소
レイヤー	레이어	1	VPl	// :장소
九折坂	구절판	1	VPe	// :도구
鍋焼きうどん	나베 야끼우동	1	VFd	// :음식(음료)
明々後日	글피	1	UMe	// :시간
タルタルソース	타르타르 소스	1	VFd	// :음식(음료)
ベーコン巻き	베이컨말이	1	VFd	// :음식(음료)
焼きプリン	야끼푸딩	1	VFd	// :음식(음료)
冷ややっこ	냉두부	1	VFd	// :음식(음료)
テホドキ	초보서	1	VBk	// :책
食あたり	식중독	1	UTi	// :질병
ヌンチャク	쌍절곤	1	VTw	// :무기
俎上	도마 위	1	VPl	// :장소
居合い刀	거합도	1	VTw	// :무기
忍服	닌자복	1	VCp	// :의복
忍刀	닌자도	1	VTw	// :무기
日本海上保安庁	일본 해상보안청	1	VPl	// :장소
不明船	불명선	1	VTp	// :교통수단
全学園	전학원	1	VPl	// :장소
やきにく	야키니쿠	1	VFd	// :음식(음료)
しょんべん	소변	1	VLu	// :분비물
おっぱーい	젖가-슴	1	VBp	// :신체부위
くりとりす	클리토리스	1	VBp	// :신체부위
移植鏝	모종삽	1	VPe	// :도구
移植ゴテ	모종삽	1	VPe	// :도구
朝めし	아침밥	1	VFd	// :음식(음료)
脳しんとう	뇌진탕	1	UTi	// :질병
菜ばし	젓가락	1	VPe	// :도구
しょうがやき	생강구이	1	VFd	// :음식(음료)
もんじゃやき	몬쟈야키	1	VFd	// :음식(음료)
竹ボウキ	대나무 빗자루	1	VPe	// :도구
竹ぼうき	대나무 빗자루	1	VPe	// :도구
ネコ撫で声	간살스러운 소리	1	UHr	// :음향&소리 상태
こし餡	으깬 팥소	1	VFd	// :음식(음료)
漉し餡	으깬 팥소	1	VFd	// :음식(음료)
粒餡	팥소	1	VFd	// :음식(음료)
羽ぼうき	깃털 빗자루	1	VPe	// :도구
羽箒	깃털 빗자루	1	VPe	// :도구
上がり症	울렁증	1	UTi	// :질병
稼ぎどき	돈벌 떄	1	UMe	// :시간
おゆはん	저녁밥	1	VFd	// :음식(음료)
けちゃっぷ	케첩	1	VFd	// :음식(음료)
煮っころがし	조림 반찬	1	VFd	// :음식(음료)
煮っ転がし	조림 반찬	1	VFd	// :음식(음료)
煮転がし	조림 반찬	1	VFd	// :음식(음료)
襁褓	기저귀	1	VCp	// :의복
奥地	오지	1	VPl	// :장소
風切り音	바람 가르는 소리	1	UHr	// :청음(소리) 상태
リブステーキ	립 스테이크	1	VFd	// :음식(음료)
ふともも	허벅지	1	VBp	// :신체부위
吠え声	짖는 소리	1	UHr	// :청음(소리) 상태
冒頭	첫머리	1	VPl	// :장소
出口らへん	출구 근처	1	VPl	// :장소
そこらじゅう	여기저기	1	VPl	// :장소
三途の川	삼도천	1	VPl	// :장소
喧騒鳴り	소란 소리	1	UHr	// :청음(소리) 상태
れんこん	연근	1	VFd	// :음식(음료)
高層階	고층	1	VPl	// :장소
烏帽子	에보시[烏帽子]	1	VCp	// :의복
しつむしつ	집무실	1	VPl	// :장소
魔王城	마왕성	1	VPl	// :장소
古城跡	고성터	1	VPl	// :장소
郡内	군내	1	VPl	// :장소
出雲国	이즈모국	1	VPl	// :장소
私鋳銭	사주전[私鑄錢]	1	VMy	// :화폐
永楽通宝	영락통보[永樂通寶]	1	VMy	// :화폐
宇佐八幡宮	우사하치만궁	1	VPl	// :장소
来待	키마치	1	VPl	// :장소
合戦場	합전장	1	VPl	// :장소
西出雲	서이즈모	1	VPl	// :장소
戦船	전선[戰船]	1	VTp	// :교통수단
三蔆	미츠비시	1	VPl	// :장소
軍機	군기	1	VTp	// :교통수단
//まほう	마법	1	UTt	// :기술
薄衣	얇은 옷	1	VCp	// :의복
吊り橋	현수교	1	VPl	// :장소
ひざ頭	무릎 관절	1	VBp	// :신체부위
膝頭	무릎 관절	1	VBp	// :신체부위
膝がしら	무릎 관절	1	VBp	// :신체부위
詰所	대기소	1	VPl	// :장소
あんまん	찐빵	1	VFd	// :음식(음료)
奥側	안쪽	1	UDr	// :방향
ククリナイフ	쿠쿠리 나이프	1	VTw	// :무기
捨て地	버린 땅	1	VPl	// :장소
二部屋	두 방	1	VPl	// :장소
商い通り	상가 거리	1	VPl	// :장소
ちんちんでんしゃ	노면전차	1	VTp	// :교통수단
ちんちん電車	노면전차	1	VTp	// :교통수단
二三時	23시	1	UMe	// :시간
膝丈	무릎 길이	1	UYl	// :길이
入院服	입원복	1	VCp	//의복
作務衣	작업복	1	VCp	//의복
ボロキレ	넝마조각	1	VLt	// :모사(모피)
配膳コーナー	주방	1	VPl	// :장소
大屋敷	대저택	1	VPl	// :장소
大城門	큰 성문	1	VPl	// :장소
玉座の間	알현실	1	VPl	// :장소
市井	시정	1	VPl	// :장소
澄酒	맑은 술	1	VFd	// :음식(음료)
澄み酒	맑은 술	1	VFd	// :음식(음료)
薬箱	약상자	1	VPl	// :장소
薬箱子	약상자	1	VPl	// :장소
市女笠	사초 삿갓	1	VCp	//의복
泥道	진창길	1	VPl	// :장소
此処	여기	1	VPl	// :장소
此所	여기	1	VPl	// :장소
彼処	저기	1	VPl	// :장소
彼所	저기	1	VPl	// :장소
其処	거기	1	VPl	// :장소
其所	거기	1	VPl	// :장소
格技	격기	1	UTt	// :기술
堅果類	견과류	1	VFd	// :음식(음료)
わんこそば	메밀국수	1	VFd	// :음식(음료)
宵空	저녁 하늘	1	VPl	// :장소
とうの昔	훨씬 전	1	UMe	// :시간
疾うの昔	훨씬 전	1	UMe	// :시간
膝関節	무릎 관절	1	VBp	// :신체부위
腰裏	허리 뒤	1	VPl	// :장소
中央区画	중앙구역	1	VPl	// :장소
奥の方	안쪽	1	UDr	// :방향 奥の方に入っちゃって
弾正台	탄정대[彈正台]	1	VPl	// :장소
さくらんぼう	체리	1	QAM	// :과일명
もぐさ	약쑥	1	VMd	// :약품
最奥部	가장 깊은 곳	1	VPl	// :장소
佐和山城	사와산성	1	VPl	// :장소
最奥付近	가장 안쪽 부근	1	VPl	// :장소
性具	성구[性具]	1	VPe	// :도구
承知の上	알고 있는 바	1	//我らもそれは承知の上だ。
しぼり汁	짜낸 즙	1	VLq	// :액체
絞り汁	짜낸 즙	1	VLq	// :액체
搾り汁	짜낸 즙	1	VLq	// :액체
拠り処	의지할 곳	1	VPl	// :장소
自分んち	자신의 집	1	VPl	// :장소
うで卵	삶은 달걀	1	VFd	// :음식(음료)
茹で卵	삶은 달걀	1	VFd	// :음식(음료)
付け根	밑[付け根]	1	VPl	// :장소
つけ根	밑[つけ根]	1	VPl	// :장소
穴倉	움막	1	VPl	// :장소
エレベーター	엘레베이터	1	VTp	// :교통수단
エレベータ	엘레베이터	1	VTp	// :교통수단
滑稽本	통속 소설[滑稽本]	1	VBk	// :책
那古屋	나고야	1	VPl	// :장소
荒子城	아라코성	1	VPl	// :장소
左脇下	왼쪽 겨드랑이 아래	1	VPl	// :장소
右脇下	오른쪽 겨드랑이 아래	1	VPl	// :장소
澳門	마카오	1	VPl	// :장소
機雷	기뢰	1	VTw	// :무기
プチトマト	방울토마토	1	QAM	// :과일명
ティラミス	티라미수	1	VFd	// :음식(음료)
ラムレーズン	럼레이즌	1	VFd	// :음식(음료)
フィナンシェ	피낭시에	1	VFd	// :음식(음료)
パン屑	빵 부스러기	1	VFd	// :음식(음료)
甲冑	갑주	1	VCp	// :의복
兵装	병장	1	VCp	// :의복
核反応炉	핵반응로	1	VPl	// :장소
獅子舞	사자춤	1	UAr	// :예술활동
メイプルシロップ	메이플 시럽	1	VCp	// :의복
亜空間	아공간	1	VPl	// :장소
サイコセラピー	사이코 세라피	1	UTt	// :기술
バンダナ	반다나	1	VCp	// :의복
梨味	배맛	1	UYa	// :맛(미각)
ランドマーク	랜드마크	1	VPl	// :장소
ロシアンティー	러시안 티	1	VFd	// :음식(음료)
並木道	가로수길	1	VPl	// :장소
厚底靴	통굽 구두	1	VCp	// :의복
避妊具	피임구	1	VPe	// :도구
密儀	비의[密儀]	1	UCl	// :종교행위(수단)
鰻の寝床	뱀장어 잠자리[鰻の寢床]	1	VPl	// :장소
キャリーバッグ	캐리어백	1	VFn	// :가구
量子コンピューター	양자 컴퓨터	1	VPe	// :도구
量子コンピュータ	양자 컴퓨터	1	VPe	// :도구
ナツメグ	육두구[ナツメグ]	1	VFd	// :음식(음료)
肉荳蒄	육두구	1	VFd	// :음식(음료)
肉豆蒄	육두구	1	VFd	// :음식(음료)
柚子	유자	1	VPt	// :식물
蛇遣い座	뱀주인 자리	1	VPl	// :장소
軽鎧	경갑	1	VCp	// :의복
重鎧	중갑	1	VCp	// :의복
御握り	주먹밥	1	VFd	// :음식(음료)
嬉し恥ずかし	기쁘고 부끄러움	1	UFl	// :감정
膝丈	무릎 길이	1	UYl	// :길이
ほりが深い顔	굴곡이 깊은 얼굴	1	VBp	// :신체부위
ほりの深い顔	굴곡이 깊은 얼굴	1	VBp	// :신체부위
ほりが浅い顔	굴곡이 얕은 얼굴	1	VBp	// :신체부위
ほりの浅い顔	굴곡이 얕은 얼굴	1	VBp	// :신체부위
堀が深い顔	굴곡이 깊은 얼굴	1	VBp	// :신체부위
堀の深い顔	굴곡이 깊은 얼굴	1	VBp	// :신체부위
堀が浅い顔	굴곡이 얕은 얼굴	1	VBp	// :신체부위
堀の浅い顔	굴곡이 얕은 얼굴	1	VBp	// :신체부위
メイド服	메이드복	1	VCp	// :의복
振る舞う食事	대접하는 식사	1	VFd	// :음식(음료)
出会い頭	만난 순간	1	UMe	// :시간
去り際	떠날 때	1	UMe	// :시간
見張り台	파수대	1	VPl	// :장소
溜池	저수지	1	VPl	// :장소
尾てい骨	꼬리뼈	1	VBp	// :신체부위
そら似	혈연 없는 닮음	1	UYh	// :인간&동물 외적 형용
空似	혈연 없는 닮음	1	UYh	// :인간&동물 외적 형용
雪解け水	해빙수	1	VLq	// :액체
雪解け道	눈 녹은 길	1	VPl	// :장소
空堀	공굴[空堀]	1	VPl	// :장소
柔らかみ	부드러움	1	UYt	// :촉감
ひとしずく	한 방울	1	VLq	// :액체
湧き水	용수	1	VLq	// :액체
魔乳	마유	1	VLq	// :액체
連れ込み宿	남녀동반 숙소	1	VPl	// :장소
よこっちょ	측면	1	VPl	// :장소
犯罪臭	범죄 냄새	1	UYm	// :냄새(후각)
つり目	치켜 올라간 눈	1	VBp	// :신체부위
吊り眼	치켜 올라간 눈	1	VBp	// :신체부위
垂れ目	쳐진 눈	1	VBp	// :신체부위
たれ目	쳐진 눈	1	VBp	// :신체부위
ヤケ酒	홧술	1	VLq	// :액체
カツオ節	가다랭이포	1	VFd	// :음식(음료)
冷しゃぶ	냉샤브	1	VFd	// :음식(음료)
恵体	타고난 몸	1	VBp	// :신체부위
兜割り	투구깨기	1	VTw	// :무기
がけっ縁	벼랑 끝	1	VPl	// :장소
崖っ縁	벼랑 끝	1	VPl	// :장소
崖っぷち	벼랑 끝	1	VPl	// :장소
禿山	민둥산	1	VPl	// :장소
裸山	민둥산	1	VPl	// :장소
離れ家	별채	1	VPl	// :장소
離れ屋	별채	1	VPl	// :장소
掠れた声	쉰 목소리	1	UHr	// :음향&소리 상태
かすれた声	쉰 목소리	1	UHr	// :음향&소리 상태
かすれてる声	쉰 목소리	1	UHr	// :음향&소리 상태
擦れた声	쉰 목소리	1	UHr	// :음향&소리 상태
擦れてる声	쉰 목소리	1	UHr	// :음향&소리 상태
かすれ声	쉰 목소리	1	UHr	// :음향&소리 상태
掠れ声	쉰 목소리	1	UHr	// :음향&소리 상태
擦れ声	쉰 목소리	1	UHr	// :음향&소리 상태
かすれた呟き	목이 쉰 중얼거림	1	UHr	// :음향&소리 상태
擦れた呟き	목이 쉰 중얼거림	1	UHr	// :음향&소리 상태
翳めた声	분명치 않은 목소리	1	UHr	// :음향&소리 상태
弾んだ声	들뜬 목소리	1	UHr	// :음향&소리 상태
下り道	내리막길	1	VPl	// :장소
壺中天	항아리속 하늘	1	VPl	// :장소
タコ部屋	쪽방	1	VPl	// :장소
たこ部屋	쪽방	1	VPl	// :장소
蛸部屋	쪽방	1	VPl	// :장소
方位磁針	나침반	1	VPe	// :도구
グーグル	구글	1	VPl	// :장소
腕ひしぎ十字固め	팔 십자꺾기	1	UTt	// :기술
ルアー釣り	루어 낚시	1	UTt	// :기술
吉方位	길한 방위	1	UDr	// :방향
つるぺた	유아 체형	1	UYh	// :인간&동물 외적 형용
天の岩戸	아마노이와토[天の岩戶]	1	VPl	// :장소
空唾	군침	1	VLq	// :액체
からつば	군침	1	VLq	// :액체
布鎧	직물 갑옷	1	VCp	// :의복
隔離牢	격리 감방	1	VPl	// :장소
牢部屋	감방	1	VPl	// :장소
牢鍵	감방 열쇠	1	VPl	// :장소
独居牢	독거 감옥	1	VPl	// :장소
囚人牢	죄수 감옥	1	VPl	// :장소
北大陸	북대륙	1	VPl	// :장소
東大陸	동대륙	1	VPl	// :장소
部屋のすみ	방구석	1	VPl	// :장소
本館	본관	1	VPl	// :장소
ハチミツ漬け	벌꿀 절임	1	VFd	// :음식(음료)
きつねソバ	메밀 유부소바	1	VFd	// :음식(음료)
きつねそば	메밀 유부소바	1	VFd	// :음식(음료)
白ワイン	화이트 와인	1	VFd	// :음식(음료)
大根おろし	무즙	1	VLq	// :액체
泥はね	흙탕물	1	VLq	// :액체 泥はねの
飼葉	여물	1	VFd	// :음식(음료)
七彩	일곱빛깔	1	UCr	// :색상
治める小さな国	다스리는 작은 나라	1	VPl	// :장소
赤紫	적자[赤紫]	1	UCr	// :색상
胸の裡	가슴 속	1	VPl	// :장소
胸裡	가슴 속	1	VPl	// :장소
奮いどころ	떨칠 곳	1	VPl	// :장소
となり村	이웃 마을	1	VPl	// :장소
ふるかわ	후루카와	1	VPl	// :장소
ひと夜	하룻밤	1	UMe	// :시간
小棚	작은 선반	1	VFn	// :가구
行きどころ	갈 곳	1	VPl	// :장소
部屋つき露天	방 딸린 노천	1	VPl	// :장소
膨れっ面	부푼 얼굴	1	VPe	// :도구 膨れ面で
ふくれ面	부푼 얼굴	1	VPe	// :도구 膨れ面で
膨れ面	부푼 얼굴	1	VPe	// :도구 膨れ面で
立ち去り際	떠날 때	1	UMe	// :시간
火打ちの石	부싯돌	1	VPe	// :도구 
湯浴み着	목욕 타올	1	VCp	// :의복
聖山	성산	1	VPl	// :장소
一か所	한곳	1	VPl	// :장소
数冊	수권	1	VBk	// :책
タネ本	기초 자료집	1	VBk	// :책
足の裏	발바닥	1	VBp	// :신체부위
はしばみ	개암나무	1	VPt	// :식물
円盾	원방패	1	VPe	// :도구
板金鎧	판금 갑옷	1	VCp	// :의복
豆腐干絲	두부건사	1	VFd	// :음식(음료)
じゃが明太	감자 명란	1	VFd	// :음식(음료)
じゃがバター	감자 버터	1	VFd	// :음식(음료)
串かつ	꼬치튀김	1	VFd	// :음식(음료)
かけ橋	가교	1	VPl	// :장소
ご機嫌気分	좋은 기분	1	UFl	// :감정
赤林檎	빨간 사과	1	QAM	// :과일명
茹でダコ	데친 문어	1	VFd	// :음식(음료)
良き時	좋을 때	1	UMe	// :시간
悪き時	나쁠 때	1	UMe	// :시간
乾き物	마른 안주	1	VFd	// :음식(음료)
ウラジーミル	블라디미르	1	VPl	// :장소
薬棚	약 선반	1	VPl	// :장소
木酢液	목초액	1	VLq	// :액체
蜻蛉切	돈보리키	1	VTw	// :무기	
忍び装束	잠입 복장	1	VCp	// :의복
はざま	틈새	1	VPl	// :장소 次元のはざま
ザー汁	정액	1	VLu	// :분비물
謁見の間	알현장	1	VPl	// :장소
登りかけの時	오르기 시작한 때	1	UMe	// :시간
クロスボウ	크로스보우	1	VPe	// :도구
いぶり漬け	이부리즈케	1	VFd	// :음식(음료)
えん麦	귀리	1	VPt	// :식물
どくだみ	삼백초	1	VPt	// :식물
うつし世	현세	1	VPl	// :장소
現し世	현세	1	VPl	// :장소
検査機具	검사 기구	1	VPe	// :도구
小袖	코소데[小袖]	1	VCp	// :의복
扉奥	문 안쪽	1	VPl	// :장소
右手扉奥	오른편 문 안쪽	1	VPl	// :장소
左手扉奥	왼편 문 안쪽	1	VPl	// :장소
姿鮨	스가다즈지	1	VFd	// :음식(음료)
略礼服	약식 예복	1	VCp	// :의복
略礼装	약식 예복	1	VCp	// :의복
まぐろ漬け	참치 절임	1	VFd	// :음식(음료)
マグロ漬け	참치 절임	1	VFd	// :음식(음료)
四川料理	사천 요리	1	VFd	// :음식(음료)
全銀河	전은하	1	VPl	// :장소
鴨肉	오리고기	1	VFd	// :음식(음료)
エビふらい	새우튀김	1	VFd	// :음식(음료)
たこ和え	문어무침	1	VFd	// :음식(음료)
とろろ	토로로	1	VFd	// :음식(음료)
飯時	끼니때	1	UMe	// :시간 その日彼が一番驚いたのは飯時の事だった。
飯時間	밥 시간	1	UMe	// :시간
歯ぶらし	칫솔	1	VPe	// :도구
焼きゴテ	인두	1	VPe	// :도구
鳴物	악기[鳴物]	1	VPe	// :도구
深き淵	깊은 심연	1	VPl	// :장소
盗賊砦	도적 요새	1	VPl	// :장소
山賊砦	산적 요새	1	VPl	// :장소
交易船	교역선	1	VTp	// :교통수단
天ざる	텐자루	1	VFd	// :음식(음료)
あちらことら	여기저기	1	VPl	// :장소
クラバット	크라바트	1	VCp	// :의복
海鮮やきそば	해물 야키소바	1	VFd	// :음식(음료)
寸胴鍋	통냄비	1	VCk	// :주방기기
うめぼし	우메보시	1	VFd	// :음식(음료)
根方	밑둥	1	VPl	// :장소
春野菜	봄야채	1	VPt	// :식물
まむしごはん	장어덮밥	VFd	// :음식(음료)
震え声	떨리는 소리	1	UHr	// :청음(소리) 상태
ぱんてぃ	팬티	1	VCp	// :의복
とんがり帽子	뾰족 모자	1	VCp	// :의복
尖り帽子	뾰족 모자	1	VCp	// :의복
修道服	수도복	1	VCp	// :의복
桶側胴	몸통 보호대	1	VCp	// :의복
秘湯	비탕[秘湯]	1	VPl	// :장소
片すみ	한쪽 구석	1	VPl	// :장소
着心地	착용감	1	VCp	// :의복
宝庫	보고[寶庫]	1	VPl	// :장소
//
元気な盛り	건강한 한창 때	0	//이건 할 수 없이 상용어구로 등록한 것. (Ehnd 는 바로 위에 등록된 명사 속성이 그 아래에 등록되는 명사에 이어지기 때문에 중간에 상용어구를 등록해준 것임.

//'명 (속성 없음)
ぼっちめし	혼밥	1
ぼっち飯	혼밥	1
掛け率	비율	1	//「対象商品本体価格×所定掛け率」となります。
米粒大	쌀알 크기	1
詰め合わせ	모듬	1
詰め合せ	모듬	1
カマイタチ	카마이타치	1
鍛治	제조	1
お家騒動	집안다툼	1
御家騒動	집안다툼	1
着つけ	옷매무새	1
声達	소리들	1
乳肉	가슴살[乳肉]	1
白玉髄	백옥수	1
玉髄	옥수	1
曼荼羅	만다라	1
ペルソナ	페르소나	1
御構い無し	상관 없음	1
おかまいなし	상관 없음	1
わびさび	수수담백[わびさび]	1	//いいよねメイド服……わびさびよね
侘び寂び	수수담백[侘び寂び]	1
行き摺り	스침[行き摺り]	1
行き摩り	스침[行き摩り]	1
ゆきずり	스침[ゆきずり]	1	//「ゆきずりの恋で結婚」
ジェニック	제닉	1
フリクション	프릭션	1
ポスティング	포스팅	1
ツナイト	투나잇	1
ヘリボー	헬리보어	1
ヘリボーン	헬리본	1
ヘリアーク	헬리아크	1
バプテスト	밥티스트	1
レーション	레이션	1
トリフィル	트리필	1
アンタイオス	안타이오스	1
印地打ち	돌팔매	1
印地	돌팔매	1
伊与	이요	1	//사람이름, 지방 이름
お先真っ暗	앞날 캄캄함	1
お先まっくら	앞날 캄캄함	1
形骸	형해[形骸]	1
形骸化	유명무실화[形骸化]	1
ディズ二ー	디즈니	1
古井戸	오래된 우물	1
リリカル	리리컬	1
白皙	흰 살결	1
良しあし	좋고 나쁨	1
善し悪し	좋고 나쁨	1
魔素	마소[魔素]	1
儲け話	돈벌이 이야기	1
フォーエバー	포에버	1
牝顔	암컷 얼굴	1
出納	출납	1
砂風呂	모레찜질	1
和魂洋才	화혼양재[和魂洋才]	1
立ち仕事	서서하는 일	1
夜討ち朝駆け	야습 취재	1
夜討朝駆け	야습 취재	1
許認可	인허가	1
春空	봄 하늘	1
東方神起	동방신기	1
淫水焼け	성관계로 인한 착색[淫水燒け]	1
淫焼け	성관계로 인한 착색[淫燒け]	1
まとめ役	책임자역	1	UAq	// :직업(신분)
浮かれ気分	들뜬 기분	1
犬神憑き	견신에 씌임	1
高襟	높은 옷깃	1
高給取り	높은 급료	1
合わせた目	맞춘 눈	1
真向勝負	정면승부	1
せっせっせ	쎄쎄쎄	1
オルシコン	오시콘	1
大欠片	큰 조각	1
矢弾	화살과 탄약[矢彈]	1
逆ハールート	역하렘 루트	1
胃もたれ	더부룩함	1
子供心	동심	1
荒くれ風	난폭한 풍	1	//荒くれ風の男
虚名	허명	1
いっぱつ	일발	1
コミュニケション	커뮤니케이션	1
死霊術	사령술[死靈術]	1
原寸大	실물 크기	1
分別書法	띄어쓰기	1
わかち書き	띄어쓰기	1
陸海軍	육해군	1
お馬さんごっこ	말타기 놀이	1
ビューアクション	뷰 액션	1	//トップビューアクションゲーム
エステリア	에스테리어	1
何年かぶり	몇년인가 만	1	//何年かぶりに人と会う
何十年かぶり	몇십년인가 만	1	//こんなでかい山は何十年かぶりってくらいにな
稼ぎ頭	주수입원	1
働きの報酬	노동의 보수	1
炎弾	화염탄	1
火炎弾	화염탄	1
尾先	꼬리 끝	1
布きれ	헝겊	1
うなり声	신음소리	1
打ち上げパーティ	뒷풀이 파티	1
重ねがけ	중복 사용	1	//魔法を重ねがけするような乱暴な真似は嫌いだが
枚挙	집계	1
錬金	연금	1
エルシー	엘시	1
エルシーディー	엘시디	1
抜き挿し	삽입질	1
旅話	여행이야기	1
乳枕	젖 베게	1
フキダシ	말풍선	1
いっぴき	한 마리	1
松ヤニ	송진	1
松やに	송진	1
ともしび	불빛	1
ひと悶着	한 말썽	1
落花生	땅콩	1
昔ばなし	옛날 이야기	1
くせ毛	곱슬머리	1
ご近所迷惑	동네 민폐	1
しっぱいさく	실패작	1
晴れトーク	쾌청 토크	1
肩叩き券	어깨 안마권	1
肩たたき券	어깨 안마권	1
何針	몇 바늘	1
幾千幾万	몇천 몇만	1
ボロ負け	참패	1
フィードバッグ	피드백	1
勝鬨	승리의 함성	1
子実	자실[子實]	1
米栽培	쌀재배	1
数切れ	몇 조각	1
クロムなめし	크롬 무두질	1
タンニンなめし	타닌 무두질	1
座椅子	좌식 의자	1
乳袋	가슴 주머니	1
雌穴	암컷 구멍	1	//この雌穴俺のにする
子袋	자궁	1
出がらし	여러번 우려냄	1
出涸らし	여러번 우려냄	1
抽挿	피스톤질[抽℡삽]	1
快楽漬け	쾌락 절임	1
精液漬け	정액 절임	1
行き遅れ	결혼 늦음[行き遲れ]	1
いき遅れ	결혼 늦음[いき遲れ]	1
そうしょくけい	초식계	1
エズラ	에즈라	1
お漏らし癖	실금하는 버릇	1
組み合わせ方式	짜맞추는 방식	1
内鍵	안쪽 열쇠	1
好物件	좋은 물건	1
つじつま	이치	1
辻褄	이치	1
ヒビ割れ	균열	1
上板	상판	1
好天気	좋은 날씨	1
薄氷	살얼음	1
身体じゅう	몸 전체	1
困り顔	곤란한 얼굴	1
屋敷構え	저택 구조	1
口説き言葉	설득하는 말	1
変わり映え	바뀐 보람	1
化粧映え	화장발	1
大木の幹	큰 나무의 줄기	1
木々の幹	나무들의 줄기	1
つくりかた	만드는 법	1
片顔	한쪽 얼굴	1
授かり婚	속도위반 결혼	1
命短し恋	짧은 사랑	1
いのち短し恋	짧은 사랑	1
短し恋	짧은 사랑	1
着岸	접안	1
明かり取り	채광창	1
あかり窓	채광창	1
明り窓	채광창	1
困苦	곤궁	1
クズハ	쿠즈하	1
キレハ	키레하	1
アトレイア	아트레이어	1
ほむら	불꽃	1
ホムラ	불꽃	1
レクイエム	레퀴엠	1
ダシアン	다시안	1
賜りし夢	받은 꿈	1
賜りしの力	받은 힘	1
星霜	성상[星霜]	1
便意	용변 마려움	1
話半分	말을 절반만 들음	1
テルテル占い	테루테루점	1
手洗い	손씻기	1
万年ビリ	만년 꼴찌	1
ゆとり教育	유토리 교육	1
湯あみ	목욕	1
湯浴み	목욕	1
ゴム毬	고무공	1
小窓	작은 창	1
船影	배의 모습[船影]	1
しりこだま	시리코다마	1
しり子玉	시리코다마	1
尻子玉	시리코다마	1
飾りピン	머리핀	1
お役御免	직무 해제	1
お役ご免	직무 해제	1
責め句	질책	1
たまの巡回	드문 순회	1
たまの機会	드문 기회	1
来歴	내력	1
生え際	머리털 안 난 언저리	1	//若いうちから生え際で悩みたくない
それらしい辨明	그럴듯한 변명	1
見憶え	본 기억	1
額の布	이마의 천	1
貫祿	관록	1
受け取り方法	받아들이는 방법	1
湯湯婆	탕파	1
大輪	대륜[大輪]	1
権威筋	권위 있는 소식통	1
逢瀬	밀회[逢瀨]	1
付け届け	선사품	1
逆髪	역발[逆髮]	1
思わせぶり	떡밥 던지기[思わせぶり]	1	//思わせぶりな態度をとる男性の心理
思わせ振り	떡밥 던지기[思わせ振り]	1
あんぜんかくにん	안전 확인	1
浮かない表情	석연치 않은 표정	1
お産み	출산	1
表法面	겉 경사면	1
のり面	경사면	1
法面	경사면	1
近所づきあい	이웃 교제	1
近所付き合い	이웃 교제	1
親戚づきあい	친척 교제	1
ご飯つぶ	밥알	1
ごはんつぶ	밥알	1
街並	거리 풍경	1
街並み	거리 풍경	1
町並	거리 풍경	1
町並み	거리 풍경	1
一階層	1계층	1
貸し一つ	빚 1개	1
シミ抜き	얼룩 빼기	1
褒め殺し	지나친 칭찬	1
誉め殺し	지나친 칭찬	1
首絞め遊び	목조르기 놀이	1
首絞め殺害	교살	1
浮名	뜬소문	1
再出馬	재출마	1
窓掛け	커튼	1
窓掛	커튼	1
突き放した口跡	매정한 말투	1	//突き放した物言い
突き放した言い方	매정한 말투	1
振り回され気味	휘둘릴 기색	1
フレンドリーさ	프랜들리함	1
引っ切り無し	끊임없음	1
ジョーシキ	상식	1
ただれた生活	방탕한 생활	1
桃割れ	모모와레[桃割れ]	1
興味深々	흥미진진	1
他言無用	누설금지	1
百花繚乱	백화요란	1
取り換えっこ	교체 놀이	1
座りションベン	앉아 소변	1
寝ゲロ	수면 구토	1
唇痕	입술 자국	1
訴求力	소구력[訴求力]	1
編み込み	머리땋기	1
湯呑み	찻잔	1
湯呑	찻잔	1
世間擦れ	닳고 닳음	1
世間ずれ	닳고 닳음	1
アバズレ	닳고 닳음	1
あばずれ	닳고 닳음	1
数頭	몇 마리	1
砂粒	모래알	1
猜疑心	시의심[猜疑心]	1
猜疑	시의[猜疑]	1
児戯	어린애 장난	1
腰紐	허리끈	1
心づくし	성의	1
ヘリオン	헬리온	1
山ごもり	산속 은둔	1
山籠もり	산속 은둔	1
湯冷め	목욕후 한기[湯冷め]	1
ご覧の有様	보시는 모양	1
御覧の有様	보시는 모양	1
ごらんの有様	보시는 모양	1
ご覧の有り様	보시는 모양	1
御覧の有り様	보시는 모양	1
ごらんの有り様	보시는 모양	1
星ふる夜	별 빛나는 밤	1
生きとし生ける物	살아있는 온갖 것	1
楽ちん	편안함	1
ノンレム睡眠	논렘 수면	1
瓦落多	잡동사니	1
すね蹴り	정강이 차기	1
大違い	크게 다름	1
水魔法	수마법	1
白魔術	백마술	1
幸多からん事	행복 가득할 것	1
幸多からんこと	행복 가득할 것	1
即断即決	즉단즉결	1
手洗いうがい	손씻기 양치질	1
職務質問	불심검문	1
出目	튀어나온 눈	1
篝火	화롯불	1
あみだくじ	사다리 타기	1
阿弥陀籤	사다리 타기	1
髪紐	머리끈	1
野ざらし	들판에 내버려둠	1
おいかけっこ	술래잡기	1
ひと段落	일단락	1
袈裟懸け	가사 걸치기[袈裟懸け]	1
袈裟掛け	가사 걸치기[袈裟掛け]	1
ガチギレ	뚜껑 열림	1
たまの息抜き	가끔의 숨돌리기	1
人遣い	사람 다루기	1
竜の髭	용의 수염	1
賭け事	도박	1
一巡り	1순회	1
二巡り	2순회	1
別アングル	다른 앵글	1
どきょう	담력	1	//おとこはどきょうよ、とケビンを励ましているかのようだ。
初狩り	첫 사냥	1
ぼうけん	모험	1
仮どめ	임시 고정[假どめ]	1
修復待ち	수복 대기	1
付け外し	붙였다 떼기[付け外し]	1
退部届け	퇴부 신고	1
氷のう	얼음 주머니	1
しっこうぶ	집행부	1
鍋ぶた	냄비 뚜껑	1
激似	꼭 닮음	1
ワンシーン	한 장면	1
あんぜん	안전	1
ねずみいっぴき	쥐 한 마리	1
うれション	기뻐서 오줌지림	1
嬉ション	기뻐서 오줌지림	1
黒こげ	숯덩이	1
るすばん	집 지키기	1
何周	몇 바퀴	1
嘘乙	구라 즐[噓乙]	1
生成り	生成り	1
話し中	대화중	1
雪解け	눈녹임[雪解け]	1
丸焦げ	완전 타버림[丸焦げ]	1
実製作	실제작	1
ひとっ飛び	단번에 날아감	1
俺向き	내 취향	1
私向き	내 취향	1
くぱぁ	쿠빠아[くぱぁ]	1
大当たり	대적중	1
皮むき	껍질 벗기기	1
数日目	수일째	1
構造体	구조체	1	//構造体へと入っていった
来園	내원[來園]	1
半分こ	반반 나누기	1
でらっくす	디럭스	1
まじっく	매직	1
ブレイド	블레이드	1
角落ち	접장기[角落ち]	1	//よくわからんけど角落ちじゃきかないだろう
声質	음질	1
梨の礫	감감 무소식	1
再出現	재출현	1
シグネチャー	시그니쳐	1
レスキュー	레스큐	1
コストパフォーマンス	코스트 퍼포먼스	1
デジタライズ	디지털라이즈	1
ボーカロイド	보컬로이드	1
ハイスペック	하이 스펙	1
ギャラクティカ	갤럭티카	1
シークレット	시크릿	1
チャリ通	자전거 통학	1
ブリザード	블리자드	1
パイレーツ	파이리츠	1
ワイズマン	와이즈먼	1
ガトリング	개틀링	1
検体	검체[檢體]	1
リブート	리부트	1
マクロスケール	매크로 스케일	1
ミクロスケール	마이크로 스케일	1
キャンセラー	캔슬러	1
泉質	천질[泉質]	1
等身大	등신대	1
アンチエイジング	안티 에이징	1
シーケンス	시퀀스	1
毒牙	독니	1
サクリファイス	새크리파이스	1
和姦	화간	1
出来過ぎ	너무 됨[出來過ぎ]	1
出来すぎ	너무 됨[出來すぎ]	1
肝の座り方	대담성 있는 태도	1	//번역어 선택 어렵다
側衛	측위[側衛]	1
がんだむ	건담	1
偶然性	우연성	1
菩提	보리[菩提]	1
耄碌	늙어빠짐	1
右手の平	오른손바닥	1
左手の平	왼손바닥	1
一度ずつ	한 번씩	1
松葉	솔잎	1
同極	동극	1
刀刃	칼날	1
化生	화생[化生]	1
幾条	몇 줄기	1
倒幕	타도 막부[倒幕]	1
手提げかばん	손가방	1
母衣衆	호로슈[母衣衆]	1	//전국시대 가신단
お味方	아군	1
陣幕	진막[陣幕]	1
大手門	정면 출입문	1
猫爪	고양이 발톱	1
総髪	총발[總髮]	1
座り読み	앉아 읽기	1
明王朝	명 왕조	1
身ぐるみ	몸에 걸친 전부	1
身包み	몸에 걸친 전부	1
//船渡し	배로 건너기	1	//本船渡し
得手不得手	특기와 서투름	1
得て不得手	특기와 서투름	1
味噌っかす	된장 찌꺼기	1
痛飲	과음	1
前後不覚	전후불각[前後不覺]	1
針千本	바늘 1000개	1
けた違い	현격한 차이	1
譬え話	비유 이야기	1
喩え話	비유 이야기	1
是々非々	시시비비	1
床上手	잠자리 능숙함	1
突っ込みタイプ	츳코미 타입	1
滑稽劇	익살극	1
滑稽	익살스러움	1
てへぺろ	데헷[혀내밀기]	1
テヘペロ	데헷[혀내밀기]	1
そったらこと	그러한 일	1
真剣勝負	진검승부	1
ヘッドハンティング	헤드 헌팅	1
五摂家	오섭가[五攝家]	1
癖っ毛	곱슬머리	1
値千金	천금 값어치	1
大人買い	대량 구매	1
自由気まま	제멋대로임	1
自由きまま	제멋대로임	1
言葉遊び	말장난	1
ジェム	잼	1
道半ば	도중	1
総取り	모두 얻기	1
ご機嫌な気分	좋은 기분	1
はてなマーク	물음표	1
訳知り顔	안다는 듯한 얼굴	1
ていたらく	꼴	1
はっけん	발견	1	//やさしくてぇ、誠実でぇ、オチンポが元気な理想のオトコはっけんだよー！
たらいまわし	차례로 돌림	1
耳許	귓전	1
足でまとい	걸리적거림	1
タイムリミット	타임 리미트	1
フェイク	페이크	1
チャージ	챠지	1
一言二言	한마디 두마디	1
着崩し方	패션붕괴 방식	1
転寝	얕은 잠	1
細指	가느다란 손가락	1
鼻梁	콧날	1
鼻の頭	코 끝	1
手櫛	손가락 빗질	1
方向感覚	방향감각	1
略奪愛	약탈애[略奪愛]	1
柔らかほっぺた	부드러운 뺨	1
半勃ち状態	반쯤 발기상태	1
汲み取り式	퍼내는 식	1
単体	단체[單體]	1
矮躯	작은 몸	1
愛念	애념	1
在りよう	존재하는 형태[在りよう]	1
嫌われよう	미움받는 모양	1
喜びよう	기뻐하는 모양	1
仰りよう	말씀하시는 모양	1
張り切りよう	의욕 넘치는 모양	1
変わりよう	변하는 모양	1
落ち着きよう	침착한 모양	1
取り乱しよう	흐트러진 모양	1
ハズレスキル	꽝 스킬	1
猫目	고양이눈	1
絞め技	조르기	1
石窯	돌가마	1
倦厭	권염[倦厭]	1
使い用	사용용	1	//어렵다. "쓸 용도" 혹은 "~용(ふだん使い用)"이 되어야 하는데... それぞれフォーマル用とふだん使い用がある居間。**難しいクエストでも使い用がある。
使いよう	사용 방법	1	//使いようによっては役に立つ。
作付状況	작황	1
虎視眈々	호시탐탐	1
擦れ傷	찰과상	1
背負いなげ	업어치기	1
物干し竿	빨래 장대	1
弾正忠	탄정충[彈正忠]	1	//관직 이름이라 함
ざらつき	껄끔거림	1
尽くめ	名:투성이	1	//良い事尽くめだな！
くびれ具合	잘록한 상태	1
弾正	탄정[彈正]	1	//벼슬 이름이라고 한다.
目ん玉	눈알	1
ソース	소스	1
相対	상대	1	//대립한다 교정 : 彼はそこで女性と相対していた。
おなじこと	같은 일	1	//湿度って、水蒸気量とおなじことですか？
はいいいえ	예 아니오	1
持ち手	손잡이	1
折鶴	종이학	1
二言三言	두 마디 세 마디	1
奪いかた	빼앗는 법	1
上乗り	위에 올라탐	1
パソ子	컴퓨터	1
むら気	변덕스러움	1	//むら気が多い。**な형용사 활용은 영향 없는 듯 : むら気で困る
斑気	변덕스러움	1
深爪	바짝 깎은 손톱	1
空回り	헛돌기	1
空封筒	빈 봉투	1
箝口令	함구령	1
見掛け倒し	겉만 번듯함	1
巾着	주머니	1
開けっぱなし	활짝 열어놓음	1	//開けっぱなしにするから。
立てひざ	한쪽 무릎 세우고 앉기	1
立て膝	한쪽 무릎 세우고 앉기	1
立膝	한쪽 무릎 세우고 앉기	1
数か所	몇 군데	1
丁髷	상투	1
首すわり	목 가누기	1
首座り	목 가누기	1
角刈り	스포츠 머리	1
伽噺	옛날 이야기	1
寸止め	슨도메[寸止め]	1
押しくらまんじゅう	밀어내기 놀이	1
これっぱかし	요만큼	1
俯きかげん	머리를 약간 숙인 상태	1
俯き加減	머리를 약간 숙인 상태	1
道筋	도리[道筋]	1
花ざかり	전성기	1
旅姿	여행 차림	1
数歩	몇 걸음	1	//数歩行ったあと軽く振り返った。
深入り	깊이 들어가기	1
何時何時	언제 어느 때	1
剣道着姿	검도복 모습	1
二十歳	20세	1
十五歳	15세	1
探査用	탐사용	1
来派	래파	1	//일본 칼 만드는 파벌. 원래 발음은 라이파
張り出し窓	내닫이창	1
出窓	내닫이창	1
ごじゅうねん	50년	1
討死	전사	1
ゆめまぼろし	몽환	1
込み込み	제반비용 포함	1
劫火	겁화	1
配膳係	배식계	1
悪態	악담	1
悪態口	악담	1
筋肉のつきかた	근육의 붙은 식	1
ヴィクトリー	빅토리	1
フォローミー	follow me	1
プラマイゼロ	플러스 마이너스 제로	1
口撃	비난	1
貧乏ゆすり	다리 떨기	1
貧乏揺すり	다리 떨기	1
最後っ屁	최후의 발버둥	1
澄まし顔	새침한 얼굴
収得	취득	1
未収得	미취득	1
開運	개운[開運]	1
混みよう	혼잡상	1
混み様	혼잡상	1
もも上げ	허벅지 올리기	1
股上げ	허벅지 올리기	1
どてっ腹	배때기	1
土手っ腹	배때기	1
二段構え	2단 구성	1
捨て石	버린 돌	1
片足立ち	한쪽 다리로 서기	1
蹴り足	차는 발	1
苛烈さ	가열[苛烈]함	1
ないないづくし	전혀 아무것도 없음	1
屈伸性	굴신성	1
むかっ腹	울컥 성질	1
向かっ腹	울컥 성질	1
霧状	안개 상태	1
霧状層雲	안개층운	1
作り置き	만들어 놓음	1
作りおき	만들어 놓음	1
もみくちゃ	구깃구깃	1
揉みくちゃ	구깃구깃	1
揉み苦茶	구깃구깃	1
間一髪	간발	1
間一髪の差	간발의 차	1
//今一	조금 더	1
再出血	재출혈	1
待ち受け画像	대기 화면	1
してやったり顔	우쭐한 얼굴	1
してやったりな顔	우쭐한 얼굴	1
うたかた	물거품	1
宗旨	종지[宗旨]	1
付き物	붙어 다니는 것	1
十数分前	십수분전	1
不精髭	깎지 않은 수염	1
無精髭	깎지 않은 수염	1
不精ひげ	깎지 않은 수염	1
無精ひげ	깎지 않은 수염	1
無精ヒゲ	깎지 않은 수염	1
腹づもり	속셈	1
心づもり	심산	1
事無かれ主義	무사안일주의	1
乾盃	건배	1
なで切り	밀어 베기	1
撫で斬り	밀어 베기	1
撫で切り	밀어 베기	1
挽肉	저민 고기	1
おべんちゃら	아첨 떨기	1
戦闘力	전투력	1
持ちもん	소유물	1
空自	공자	1	//항공 자위대 : 領空侵犯に対する空自のスクランブルは、頻繁に行われている。
片眉	한쪽 눈썹	1
ひとめぐり	한 바퀴 돌기	1
ひと欠片	한 조각	1
おとがめ無し	추궁하기 없음	1
お咎め無し	추궁하기 없음	1
お咎めなし	추궁하기 없음	1
持ち合わせ	가진 것	1
持ちあわせ	가진 것	1
掴みどころ	붙잡을 곳	1
道幅	도폭	1
迷惑千万	민폐천만	1
セールストーク	세일즈 토크	1
ゆいいつ	유일	1
とんこつ	돈코츠	1
厨二心	중2 마음	1
四つ目	네번째	1
塵芥	쓰레기	1
鷄口牛後	계구우후	1
牛後	소꼬리	1
先々月	지지난달	1
付け替え工事	교체 공사	1
百人一首	백인일수[百人一首]	1
引っ掛け問題	낚시 문제	1
和同開珎	화동개진[和同開珍]	1
私鋳	사주[私鑄]	1
悪銭	악전[惡錢]	1
大納言	대납언[大納言]	1	//벼슬 이름
中納言	중납언[中納言]	1	//벼슬 이름
権大納言	권대납언[權大納言]	1
揉みかた	주무르는 방식	1
狐付き	여우에 홀림	1
きつねつき	여우에 홀림	1
狐憑き	여우에 홀림	1
どんぱち	빵야빵야	1
ドンパチ	빵야빵야	1
城代	성 대리[城代]	1	//城代家老
郡代	군 대리[郡代]	1
猿りこう	잔꾀	1
ちゅうおうしゅうけん	중앙집권	1
くずし字	흘려쓴 글자	1
探題	탐재[探題]	1	//옛날 벼슬 이름이었다 함
林立	임립[林立]	1
普通の人並	보통의 남들 수준	1
普通の人並み	보통의 남들 수준	1
筋金入り	굳건한 신념	1
一筋の光明	한 줄기의 광명	1
眼福	눈의 복[眼福]	1
行った儀式	행한 의식	1
女ごころ	여자 마음	1
デビュタント	데뷔탕트	1
源平藤橘	겐페이토우키츠[源平藤橘]	1
小部隊	소부대	1
何隻	몇척	1
荷姿	하자[荷姿]	1
可愛いげ	귀염성	1
砂金取り	사금 채취	1
家内経営	가내경영	1
家内一統	가내일통	1
家内繁盛	가내번창	1
鐚一文	단돈 한푼	1
鐚銭	아전	1	//에도시대의 돈
家司	가사	1
叙任	서임	1	//関白に叙任された
縦揺れ	상하 흔들림	1
頭陀袋	주머니	1
首陀袋	주머니	1
ずだ袋	주머니	1
クオリティー	퀄리티	1
泣きぼくろ	눈가의 사마귀	1
泣黒子	눈가의 사마귀	1
ごぶごぶ	비슷비슷	1
五分五分	비슷비슷	1
激混み	격한 혼잡함	1
オス犬ゴッコ	수캐놀이	1
メス犬ゴッコ	암캐놀이	1
抱き癖	안기기 버릇	1
抱きかご	죽부인	1
抱き籠	죽부인	1
英雄伝説	영웅전설	1
透け方法	비치는 방법	1
透け方	비치는 식	1
ふりがな	후리가나	1
振り仮名	후리가나	1
ひと噛み	한번 깨물기	1
ひと睨み	한번 노려붐	1
いしがま	돌가마	1
猛省	맹성[猛省]	1
一噛み	한번 깨물기	1
操糸	명주실 뽑기	1
満たん	만땅	1
四十路	40세	1
線香	선향	1
沈香	침향	1	//나무 이름, 향료 이름이다.
未発見	미발견	1
明晰夢	자각몽	1
大振り	크게 휘두르기	1
ひざ送り	무릎 걸음	1
膝送り	무릎 걸음	1
来国	내국[來國]	1
リブ	리브	1	//발음
各流派	각 유파	1
高段位	고단위	1
かくしばしょ	숨긴 장소	1
婚活	결혼활동	1
話の流れ	이야기의 흐름	1
剣神流	검신류	1
どや顔	의기양양한 얼굴	1
禿頭	대머리	1
十把一からげ	싸잡아 취급	1
十把一絡げ	싸잡아 취급	1
事務多忙	사무다망	1
村起こし	마을 일으키기	1
小太り	약간 통통함	1
横入り	새치기	1
留め処	끝	1
止め処	끝	1
鼻っ柱	콧대	1
月の物語	달의 이야기	1
御出座し	행차	1
ふたことめ	입버릇	1
食いもん	먹을 것	1	//何か食いもんを取ってきて座れよ
ひとばんじゅう	밤새	1
ガブ飲み	벌컥벌컥 마시기	1
がぶ飲み	벌컥벌컥 마시기	1
あそびはんぶん	장난반	1
こんぷれっくす	컴플렉스	1
スネかじり	얹혀사는 처지	1
すねかじり	얹혀사는 처지	1
クサレエン	지긋지긋한 인연	1
なかなおり	화해	1
ひつぜん	필연	1
罪滅し	속죄	1
みそっかす	된장 찌꺼기	1
枯れすすき	마른 억세풀	1
やつざき	갈가리 찢음	1
ぷらとにっく	플라토닉	1
臍繰り	비자금	1
竹かご	대바구니	1
はっけーん	발견	1
孤影悄然	고영초연	1
みすてりあす	미스테리어스	1
えくせれんと	엑셀런트	1
雪がっせん	눈싸움	1
しめ縄	금지줄	1
ワタボコリ	솜털	1
心がわり	변심	1
ヤジロベー	평형 인형	1
ヤジロベエ	평형 인형	1
弥次郎兵衛	평형 인형	1
キンシンソーカン	근친상간	1
揃いぶみ	스모선수 땅구르기	1
揃い踏み	스모선수 땅구르기	1
ぷろぽーず	프로포즈	1
ぐっどないと	굿나잇	1
ますたーべーしょん	마스터베이션	1
定期健診	정기검진	1
相合い傘	같이 우산쓰기	1
あいあいがさ	같이 우산쓰기	1
相合傘	같이 우산쓰기	1
ふりかえやすみ	대체휴일	1
振り替え休み	대체휴일	1
すりーさいず	쓰리사이즈	1
猫なで声	간살스러운 소리	1
ひと区切り	일단락	1
ばんばんざい	만만세	1
きんきゅーじたい	긴급사태	1
きんきゅうじたい	긴급사태	1
りんきおうへん	임기응변	1
ないしょばなし	비밀 이야기	1
だいかつやく	대활약	1
うぇるかむ	웰컴	1
ぱーふぇくと	퍼펙트	1
あんざんがた	순산형	1
りょーてに花	양손에 꽃	1
がちんこ	진검승부	1
若禿げ	젊어서 대머리	1
若禿	젊어서 대머리	1
若はげ	젊어서 대머리	1
やり甲斐	하는 보람	1
歳甲斐	나이 먹은 보람	1
年甲斐	나이 먹은 보람	1
ちょうしはずれ	상태 벗어남	1
調子っぱずれ	상태 벗어남	1
調子外れ	상태 벗어남	1
夜ばい	요바이	1
ひっさつわざ	필살기	1
気転	재치	1
ぴり辛	엄청 매움	1
ピリ辛	엄청 매움	1
言掛り	트집	1
わたぼこり	솜털	1
目ヤニ	눈곱	1
てんばつ	천벌	1
ヤブヘビ	긁어 부스럼	1
ヤブ蛇	긁어 부스럼	1
やぶへび	긁어 부스럼	1
ぎぶあっぷ	기브업	1
うんめい	운명	1
おーるうぇいず	올웨이즈	1
こみゅにけーしょん	커뮤니케이션	1
ばんざーい	만-세	1
ボーズ頭	스님머리	1
ぷれぜんと	프레젠트	1
紙ふぶき	종이조각	1
やんでれ	얀데레	1
クジ引き	제비뽑기	1
御名前	성함	1
ウサ晴らし	기분전환	1
曰く付き	복잡한 사정	1
曰わく付き	복잡한 사정	1
いわくつき	복잡한 사정	1
肌つや	피부 윤기	1
のん気	만사태평	1
呑気	만사태평	1
頼み事	부탁할 일	1
寝グセ	잠버릇	1
御開き	폐회	1
うかない顔	우울한 얼굴	1
うかないかお	우울한 얼굴	1
浮かない顔	우울한 얼굴	1
ぬけがけ	몰래 앞지르기	1
抜け駆け	몰래 앞지르기	1
茹蛸	삶은 낙지	1
はっぴいえんど	해피 엔드	1
はっぴーえんど	해피 엔드	1
ニンギョウ	인형	1
ニンギョー	인형	1
だだ漏れ	줄줄 샘	1
ぷりーず	플리즈	1
大甘菜	대감채	1
ホメ言葉	칭찬	1
ゴホウビ	포상	1
しっぱい	실패	1
ガラクトオリゴ糖	갈릭토 올리고당	1
キュート	큐트	1	//
三行	3행	1	//
河童の屁	캇파의 방귀	1
かっぱの屁	캇파의 방귀	1
屁のかっば	캇파의 방귀	1
屁の河童	캇파의 방귀	1
不撓不屈	불요불굴	1
継ぎ接ぎ	누덕누덕	1
宿がえ	이사	1
貴船	귀선	1
無駄毛	쓸데없는 털	1
ムダ毛	쓸데없는 털	1
大切断	대절단	1
飛車	비차	1	//원래 장기말 이름
火達磨	불덩이	1
しっちゃかめっちゃか	엉망진창	1
御機嫌伺い	안부 묻기	1
ご機嫌伺い	안부 묻기	1
グッバイ	굿바이	1
灯台下暗	등하불명	1
灯台下暗し	등하불명	1
近所迷惑	이웃 민폐	1	//近所迷惑だとかなんだとか
豆腐頭	두부 머리	1	//その豆腐頭を少しでも賢くしたかったら
もぐらたたき	두더지 잡기	1
呵々大笑	박장대소	1
蝶々結び	나비 매듭	1
砂出し	모래 제거	1	//砂出しは十分のようね。
砂出し済み	모래 제거 완료	1
ひいき目	호의적인 눈	1
贔屓目	호의적인 눈	1
長風呂	긴 목욕	1	//長風呂しちゃいました
ガス欠	연료 떨어짐	1
料理の腕前	요리 솜씨	1
料理の腕	요리 솜씨	1	//アンタ料理の腕あがってるわねー
直帰	근무처 퇴근	1
冬限定	겨울 한정	1
ヘッドロック	헤드락	1
機嫌顔	기분 좋은 얼굴	1
チラ見	힐끗 봄	1
チラ見え	힐끗 보임	1
チラ見せ	힐끗 보임	1
モロ見	죄다 봄	1
モロ見え	죄다 보임	1
モロ見せ	죄다 보임	1
もろ見	죄다 봄	1
もろ見え	죄다 보임	1
もろ見せ	죄다 보여줌	1
ひとさじ	한 숟가락	1
せっかち	성급함	1	//なにの 로 쓰임 : せっかちは女の子に嫌われるわよ。
綿埃	솜털	1
綿ぼこり	솜털	1
飯代	밥값	1
和気靄靄	화기애애	1
プラーザ	플라자	1
システムエラー	시스템 에러	1
ソースコード	소스 코드	1
ライブラリー	라이브러리	1
ストロング	스트롱	1
ちゃんばらごっこ	칼싸움 놀이	1
人外魔境	인외마경	1
部屋わり	방 배정	1
一泊二日	1박 2일	1
狂騒	미친 소란	1
ドッグファイト	도그 파이트	1
有り体	있는 그대로	1
ロードマップ	로드맵	1
赤提灯	붉은 초롱	1
スパーキング	스파킹	1
シャブ	샤브	1
卍固め	만자 굳히기	1
チョーキング	쵸킹	1
紐付け	연관	1
ちゃらんぽらん	대강대강	1
チャランボラン	대강대강	1
あみぐるみ	뜨개질 인형	1
棒演技	발연기	1
ラビ	라비	1
ミステリアス	미스테리어스	1
フィヨルド	피요르드	1
手前味噌	자화자찬	1
いざ鎌倉	위급사태	1
自分流	자신류	1
スクェア	스퀘어	1
ブライトネス	브라이트니스	1
デザイアー	디자이어	1
ステレオタイプ	스테레오 타입	1
ジョーク	조크	1
イングリッシュ	잉글리쉬	1
不適合	부적합	1
コンスタント	콘스탄트	1
レプラコーン	레프라콘	1
バング	뱅	1
シャドウ	쉐도우	1
トラディショナル	트래디셔널	1
アクト	액트	1
背脂肪厚	등 지방 두께	1
月水金	월수금	1
耐え性	참을성	1
中二言動	중2 언동	1
リップサービス	립서비스	1
目玉企画	핵심 기획	1
ノーブレスオブリージュ	노블레스 오블리쥬	1
辻演奏	거리 연주	1
マーマレード	마멀레이드	1
ブラザーフッド	브라더후드	1
ハンドレッド	헌드레드	1
ウサ耳	토끼귀	1
エレ	에레	1
ランチャー	런처	1
袋だたき	뭇매	1
三輪	삼륜	1
リップスティック	립스틱	1
南斗六星	남두육성	1
ミッシング	미싱	1
疫学的	역학적	1
夜風呂	밤목욕	1
ショコラ	쇼콜라	1
オーソドックス	오소독스	1
包装袋	포장봉투	1
アクタイオン	악타이온	1
正二十面体	정이십면체	1
コバルトブルー	코발트 블루	1
地産地消	자급자족	1
セコンド	세컨드	1
うしかい座	목동자리	1
しぶんぎ座	사분의 자리	1
大袋	큰 봉투	1
マイスター	마이스터	1
ブービー賞	꼴등상	1
フィンガー	핑거	1
炭焼	숯불구이	1
炭焼き	숯불구이	1
枝切り	가지치기	1
ペアルック	페어룩	1
プラカード	플래카드	1
サイドワインダー	사이드 와인더	1
サブカルチャー	서브컬쳐	1
ホームグラウンド	홈그라운드	1
ポケットマネー	포켓머니	1
ホールド	홀드	1
スレッド	스레드	1
オーヴァー	오버	1
プロトタイプ	프로토타입	1
初号機	초호기	1
操船方法	조선방법	1
ブースタ	부스터	1
射点	사점	1
シックスティーン	식스틴	1
ピカ	피카	1	//발음
トラバース	트래버스	1
横走行	횡주행	1
願掛け	발원	1
熱割れ	열 균열	1
デヴィル	데빌	1
ベント	밴트	1
妹背結び	부부 맺기	1
御贄	진상물	1
タヌキ寝入り	자는 척	1
魂刈り	영혼베기	1
日なたぼっこ	햇볕쬐기	1
クラッキング	크래킹	1
ユークリッド	유클리드	1
自薦他薦	자천타천	1
オリジナリティ	오리지널리티	1
アイリッシュ	아이리쉬	1
ストリング	스트링	1
インべイド	인베이드	1
手延べ	손으로 면 뽑은	1	//手延べうどん
メカニック	메카닉	1
エレガント	엘레강트	1
陣中見舞い	진중위문	1
チャップマン	채프먼	1
ペンタグラム	펜타그램	1
広背筋	광배근	1
ポルノグラフィー	포르노그라피	1
無月経	무월경	1
ニーチェ	니체	1
レジェンド	레전드	1
懐事情	주머니 사정	1
アングリー	앵그리	1
バイパス	바이패스	1
ブリ	브리	1
ルーニー	루니	1
果たし合い	결투	1
イレギュラー	이레귤러	1
バックドア	백도어	1
シャトー	샤토	1
鵜飼い	가마우지 낚시	1
呆然自失	망연자실	1
レディース	레이디스	1
チェーホフ	체홉	1
蛇蝎	뱀과 전갈	1
ファッショナブル	패셔너블	1
ネアンデルタール	네안데르탈	1
ペインティング	페인팅	1
赤目	붉은 눈	1
リスタート	리스타트	1
合縁奇縁	합연기연[合緣奇緣]	1
手描き	손으로 그리기	1
しゃぼん玉	비누방울	1
不機嫌面	불쾌한 얼굴	1
内輪揉め	집안 싸움	1
二年参り	2년 참배	1
モンタギュー	몬테규	1
メンデルスゾーン	멘델스존	1
モグラ叩き	두더지잡기	1
ボイスレコーダー	보이스레코더	1
ハンドマイク	핸드마이크	1
へびつかい座	뱀주인자리	1
ごまだれ	참기름 양념장	1
ごま垂れ	참기름 양념장	1
プリペイド	프리페이드	1
見廻り	순찰	1
ニップ	닙	1	//발음
ツバキ	츠바키	1
エディンバラ	에딘버러	1
ツバメ	츠바메	1
コメリア	코메리아	1
パンプアップ	펌프업	1
三教示	3교시	1	//오류어휘
オーバーワーク	오버워크	1
競泳	경영	1
チェーンジ	체인지	1
なまはげ	나마하게	1	//유명한 행사 이름
アカプルコ	아카폴코	1
目くらまし	눈속임	1
ヒャッハー	햣하	1	//발음
寸刻	촌각	1
ガントレッド	건틀렛	1
黒焦げ	숯덩이	1
黒ずくめ	검정 일색	1
回れ右	우향우	1
香り付け	향기 내기	1
//荒事	험한 동작	1
風見鶏	풍향계	1
芭蕉扇	파초선	1
通せんぼ	길막기	1
値打ち物	값나가는 물건	1
超常的	초현실적	1
置いてけぼり	따돌림	1
おいてけぼり	따돌림	1
超常現象	초현실 현상	1
超弩級	최대급	1
貼り紙	벽보	1
鉄の柵	철 울타리	1
斬り傷	자상	1
着痩せ	입으면 말라보임	1
職質	불심검문	1
フリーク	프리크	1	//발음
持切り	자자함	1	//そのうわさで持切りだ
持ち切り	자자함	1	//そのうわさで持ち切りだ
もちきり	자자함	1	//サッカー部でもその話題でもちきりだもん
重装甲	중장갑	1
重機関	중기관	1
中だるみ	중간에 해이해짐	1
中弛み	중간에 해이해짐	1
俊英	준영[俊英]	1
足の引っ張りあい	서로 다리 잡아당기기	1
足の引っ張り合い	서로 다리 잡아당기기	1
早駆け	전력 달리기	1
遭遇率	조우율	1
組み手	대련 상대[組み手]	1
伝国璽	전국 옥새	1
敵勢力	적세력	1
吊り橋効果	현수교 효과	1
姉御肌	여장부 기질	1
姐御肌	여장부 기질	1
長押し	오래 누르기	1
姿形	모습	1
髭ヅラ	수염 얼굴	1
入島	입도	1
一斉射	일제사	1
一皿	한 접시	1
刃筋	검날	1
異性愛	이성애	1
意匠	의장	1
応射	응사	1
油坊	도깨비불	1
月輪	월륜	1
頻繁	빈번	1
外気温	바깥 기온	1
王威	왕위[王威]	1
腕っぷし	팔힘	1
陽動	양동	1
夜通し	밤새도록	1
押し引き	밀고 당기기	1
悪目立ち	나쁜 눈초리	1
実体験	실체험	1
勝ち逃げ	이기고 도망침	1
膝射	무릎쏴	1
消波ブロック	방파제	1
洗濯籠	세탁 바구니	1
説き文句	작업 문구	1
選択肢	선택지	1
船代	배삯	1
先々代	선선대	1
三文芝居	삼류 연극	1
体当たり	몸통 박치기	1
不行届き	소홀	1
不行届	소홀	1
白髭	흰수염	1
黙殺	묵살	1
武者震い	전율	1
目覚めのキス	모닝 키스	1
目ざめのキス	모닝 키스	1
買い取り値	매입가	1
幕引き	종막	1
立ち振舞い	행동거지	1
霊視	영시[靈視]	1
力加減	힘 조절	1
同地	동지[同地]	1
董白	동백	1
東門	동문	1
年寄り呼ばわり	늙은이 취급	1
金ピカ	금삐까	1
金ぴか	금삐까	1
吉祥天	길상천	1
急場造り	급조 공사	1
機械弄り	기계 조작	1
九連環	구련환	1
藻くず	물고기밥	1
藻屑	물고기밥	1
歌い文句	선전문구	1
謳い文句	선전문구	1
観察眼	관찰안	1瓜二つ	판박이	1
警備体勢	경비체제	1
警邏	순찰	1
鑑定眼	감정안	1
マスケット	머스킷	1
ジャパニメーション	재패니메이션	1
シックスナイン	식스나인	1
シェパード	셰퍼드	1
せっ毛	곱슬머리	1
キングダム	킹덤	1
キャンドル	캔들	1
ゲイザー	게이저	1
ひづめ	발굽	1
ギブン	기븐	1	//발음
ガラティーン	갈라틴	1
かまいたち	카마이타치	1
カタパルト	캐터펄트	1
ガウス	가우스	1	//발음
カーマスートラ	카마수트라	1
お摘み	안주	1
お役御免	면직	1
お尻ぺんぺん	엉덩이 팡팡	1
シグニア	시그니어	1
ガイオス	가이오스	1	//발음
アクロバット	아크로바트	1
アープ	아프	1
戦術眼	전술안	1
大道芸	거리 공연	1
王派	왕파	1
有志	유지	1
密命	밀명	1
毛並み	털의 결	1
宝箱	보물상자	1
ボロ布	걸레	1
これっぽち	이것뿐	1
それっぽち	그것뿐	1
あれっぽち	저것뿐	1
セオリー	씨어리	1
ただ働き	무상 봉사	1
藁束	짚단	1
絡め手	손기술	1	//유도등
渾名	별명	1
にやけ顔	히죽거리는 얼굴	1
銃爪	방아쇠	1
貪欲さ	탐욕스러움	1
味わい深さ	맛의 깊이	1
積極さ	적극성	1
不精さ	게으름	1
ソーシャル	소셜	1
ホーリー	홀리	1	//발음
答え合わせ	채점	1
鳥卵	새알	1
掠り傷	찰과상	1
高評価	고평가	1
パパラッチ	파파라치	1
ビビリ	비비리	1	//발음 때문.
バースト	버스트	1
ぺニス	페니스	1
耕作	경작	1
刃紋	칼날 문양	1
抜き足	살금살금 걸음	1
差し足	살금살금 걸음	1
忍び足	살금살금 걸음	1
しのび足	살금살금 걸음	1
電波の入り方	전파가 들어가는 방식	1	//機種によって電波の入り方は違いますか？
刃の入り方	칼날이 들어가는 방식	1	//刃の入り方が鋭過ぎる。
実経験	실경험	1
刃こぼれ	칼날 이가 빠짐	1
刃毀れ	칼날 이가 빠짐	1
短躯痩身	작고 마른 몸	1
長躯痩身	크고 마른 몸	1
痩身長躯	마르고 키가 큼	1
痩身	마른 몸	1
三つ編み	세가닥 땋기	1
戦略眼	전략안	1
職人肌	장인기질	1
籠りっぱなし	두문불출	1
大所帯	대가족	1
鈴なり	주렁주렁 몰림	1
鈴生り	주렁주렁 몰림	1
槍衾	창금[槍衾]	1
擬い	모조	1	//まがい
メルシー	메르시	1
混じりっけ	불순물	1
混じりけ	불순물	1
臨死体験	임사체험	1
ウイーンウイーン	윈윈	1
しゃれこうべ	해골	1
されこうべ	해골	1
炬燵	코타츠	1
百も承知	불문가지[百も承知]	1
百も承知二百も合点	1백도 알고 2백도 납득	1
責折檻	괴롭힘	1
折檻	엄벌	1
金縛り	속박[金縛り]	1
甲羅干し	일광욕	1
大中小	대중소	1
人だかり	사람무리	1
ひとだかり	사람무리	1
エディション	에디션	1
ひとつ目	첫 번째	1
ガイスト	가이스트	1
ブレイズ	블레이즈	1
マグノリア	매그놀리아	1
クラフト	크래프트	1
フォルト	폴트	1
ベッドシーン	베드신	1
立て襟	세운 옷깃	1
無駄死	헛된 죽음	1	//そんな無駄死にはしたくないわね」
跳ね橋	현수교	1
騙し討ち	속임수	1
エンゲージ	인게이지	1
跳ね橋	현수교	1
オールラウンダー	올라운더	1
ブリッツ	블리츠	1
使い心地	사용감	1
スニーキング	스니킹	1
念話	염화[念話]	1
水袋	물주머니	1
毛むくじゃら	털투성이	1
苗床	모판[苗床]	1
死にものぐるい	필사적인 몸부림	1
帽子の鍔	모자챙	1
大一番	중요한 승부	1
スラッシュ	슬래시	1
シェーダ	셰이더	1
シェイカー	셰이커	1	//シェイカー
丸かじり	통째로 베어물음	1
石くれ	돌멩이	1
ソルト	솔트	1
スーパーコンピュータ	수퍼 컴퓨터	1
屈強	강인	1
隠れんぼ	숨바꼭질	1
形見	유품	1
脛かじり	부모 슬하	1
臑齧り	부모 슬하	1
フルスロットル	풀 스로틀	1
覚え立て	갓 기억함	1	//お互い、覚え立てだった頃は
テクスチャ	텍스처	1
盾役	방패 역할	1
風光明媚	풍광명미	1
明媚	명미[明媚]	1
サイファー	사이퍼	1
サープラス	서플러스	1	//サープラスメイル//サープラススピア
立ちくらみ	현기증	1
マトリクス	매트릭스	1
ムーン	문	1	//발음 シルバームーン
夜の伽	밤 시중	1
燃料ぎれ	연료 고갈	1
弓弦	활시위	1
キャタピター	캐터필터	1	//에벌레, 데모니온2
月灯り	달빛	1
念動	염동	1
落としどころ	합의점	1
とっかかり	실마리	1
取っ掛かり	실마리	1
ブロッサム	블로섬	1	//オレンジブロッサム
目鼻立ち	이목구비	1
菓子折り	과자 선물상자	1
大金星	대성과	1	//この勇者を魅了できれば、大金星！
スタンダート	스탠더드	1
大根芝居	싸구려 연극	1
尻上がり	상승세	1
尻叩き	엉덩이 때리기	1	//悪いことしたら尻叩きってのは定番だろ」
シェルフ	셀프	1
物見遊山	관광유람	1
立ち番	감시역	1
丸無視	완전 무시	1
悩みどころ	고민거리	1
月光浴	월광욕	1
全科目	전과목	1
地鶏	토종닭	1	VAm	// :동물
飾りつけ	장식	1
逆鱗	역린[逆鱗]	1
皮袋	가죽부대	1
クリーパー	크리퍼	1
マンイーター	맨 이터	1
フリージング	프리징	1	//발음
ブリガン	브리건	1	//발음
バスタード	바스타드	1
ワンド	완드	1	//발음
ウォーハンマートゥル	트루	1
ビートル	비틀	1
バンデッド	밴딧	1
スパイダー	스파이더	1
クェーサー	퀘이사	1
プロミネンス	프로미넌스	1
隠れ身	은신	1
逆恨み	역원한[逆恨み]	1
預かりもの	맡은 물건	1
オーラルセックス	오럴 섹스	1
ヘイスト	헤이스트	1
羽交い絞め	하가이지메[羽交い絞め]	1	//
御開帳	개장	1
湯上り	목욕마침[湯上り]	1
湯上り姿	갓 목욕한 모습	1
湯上りタオル	묙욕용 수건	1
何代	몇 대	1
カムフラージュ	카모플라지	1
バシュム	바슘	1
ダブルショット	더블샷	1
ブリンク	블링크	1
ウィンド	윈드	1
ディストーション	디스토션	1
大竜巻	큰 회오리	1
コンセントレーション	컨센트레이션	1
ソニックブーム	소닉붐	1
ウォークライ	워 크라이	1
ブルームーン	블루문	1
フロスト	프로스트	1
へイル	헤일	1	//발음
サイレンス	사일런스	1
クリアランス	클리어런스	1
イミュニティ	이뮤니티	1
コンフュージョン	컨퓨전	1
フシアナ	아시아나	1
タイクーン	타이쿤	1	//발음
もーちろん	물-론	1
チュッチュ	츗츄	1	//발음
カード	카드	1
野垂れ死	길바닥에 쓰러져 죽음	1
のたれ死	길바닥에 쓰러져 죽음	1
まいど	매번	1
狡猾	교활	1	//오류 명사이며, 형용사형은 필터로 등록.
外様	방계[外樣]	1	//오류 어휘
縛めのなわ	포승	1
片荷	한쪽 짐	1
構成要素	구성요소	1
一ひねり	한 번 비틀음	1	//ひげを一ひねりする
魔封じ	마봉인	1
とばっちり	물보라	1
景気づけ	승리 기원	1
別方向	다른 방향	1
これっぼっち	요만큼	1
食いつき	입질[食いつき]	1
納得ずく	충분히 납득	1	//명사라고 한다
納得づく	충분히 납득	1	//명사라고 한다
納得尽く	충분히 납득	1	//명사라고 한다
落とし前	뒷수습	1	//落とし前はつけさせてやる。
高楊枝	이 쑤시기	1
カツアゲ	공갈	1
かつあげ	공갈	1
喝上げ	공갈협박	1
カツ上げ	공갈협박	1
百度参り	백번 기원	1
骨抜き	뼈 없음[骨拔き]	1
囚われの身	사로잡힌 몸	1
システマチック	시트터매틱	1
お上品	상품	1	//いまさらお上品ぶるなよ、お姫様。
ホーネット	호넷	1
金魚掬い	금붕어 건지기	1
刀の素振り	칼 휘두르기	1
剣の素振り	검 휘두르기	1
半分っこ	절반씩	1	//肩の荷物は 半分っこ
試し切り	시험 베기	1
ブロークン	브로큰	1
調べもの	조사할 것	1
青姦	청간[靑姦]	1
建て付け	만듦새	1	//동사형은 거의 안 쓰이는 듯
出来損ない	덜 떨어짐	1	//명사라고 한다.
昔の借り	예전의 빚	1	//昔の借りもあるし、
役立たず	쓸모없음	1	//명사로 해도 괜찮을 듯하다. この、役立たずどもめっ……！
大振りの攻撃	크게 휘두르는 공격	1
ナゲット	너겟	1
マキアート	마키아토	1
ノスフェラトゥ	노스페라투	1
ロックオン	락온	1
アーティスティック	아티스틱	1
アイサツ	인사	1
アヴァランチ	아발란체	1
あかんべ	메롱	1
あっかんべ	메롱	1
アキバ	아키바	1
アクビ	하품	1
アクメ	절정	1
あつらえむき	안성맞춤	1
アトラクション	어트렉션	1
アナウンス	어나운스	1
アバンチュール	아방튜르	1
アビリティ	어빌리티	1
アフタケアー	애프터캐어	1
あべこべ	뒤바뀜	1
アポカリプス	아포칼립스	1
アメニティ	편의시설	1
アリジゴク	개미지옥	1
あるばいと	아르바이트	1
アレコレ	이것저것	1
あれっきり	저것 뿐	1
アロマ	아로마	1
アンバランス	언밸런스	1
イースター	이스터	1
イイデキ	잘 만듦	1
イエロ	옐로	1
イカサマ	사기	1
イカレた話	얼빠진 이야기	1
イキサツ	경위	1
イキッぱなし	가고 있는 채	1
イキっぱなし	가고 있는 채	1
イキッぷり	가는 모습	1
苛められっぱなし	괴롭혀지고 있는 채	1
褒められっぱなし	칭찬되어지고 있는 채	1
イキ方	가는 방법	1
イグザクトリ	이그잭틀리	1
イケニエ	제물	1
いけ炭	잿불	1
いけ火	숯불	1
イチイチ	하나하나	1
いぢめ	괴롭힘	1
いっきいちゆう	일희일비	1
いっしんいったい	일진일퇴	1
いっせきにちょ	일석이조	1
いっちょういっせき	일조일석	1
いっちょういったん	일장일단	1
イッパツ	한 발	1
イナズマ	번개	1
イニシアチブ	이니셔티브	1
イミニティー	이뮤너티	1
イメチェン	이미지 체인지	1
イメトレ	이미지 트레이닝	1
イモータル	임모탈	1
イヤガラセ	짓궂은 장난	1
イングラム	잉그램	1
インスパイア	인스파이어	1
インパルス	임펄스	1
インボー	음모	1
ヴァイタルエクステンション	바이탈 익스텐션	1
ヴィデオ	비디오	1
ウェットティッシュ	물티슈	1
ウォーターブレイド	워터블레이드	1
うずみ火	숯불	1
うすら笑い	엷은 웃음	1
うす笑い	엷은 웃음	1
えいえん	영원	1
うるとら	울트라	1
うわの空	건성	1
エクスプロード	익스플로드	1
エクトプラズム	엑토프라즘	1
えづけ	길들임	1
エブリバデェ	에브리바디	1
エリクサー	에릭서	1
エレメンタル	엘레멘탈	1
えろいこと	에로한 것	1
えろいもの	에로한 것	1
エロゲー	에로게임	1
エンカウント	인카운터	1
エンコー	원조교제	1
エンジョイ	엔조이	1
エントランス	엔트렌스	1
オウム返し	앵무새 흉내	1
オーラ	오라	1
おかえし	답례	1
オカルティック	오컬틱	1
オカルト	오컬트	1
おしごと	일	1
オシマイ	끝	1
おしゃぶり	빨기	1	//また顔を伏せておしゃぶりを再開させた。
おじゃん	허사	1
おそうじ	청소	1
おためごかし	남을 위해주는 체	1
おたんじょうび	생일	1
おたんじょう日	생일	1
おたんじょーび	생일	1
おちょこ	술잔	1
オナニー	자위	1
オネダリ	졸라댐	1
おねだり	졸라댐	1
オハナシ	이야기	1
オブリージュ	오블리주	1
オブリッジ	오블리지	1
おべんきょう	공부	1
オムツ	기저귀	1
おめざめ	눈을 뜸	1
おもてなし	대접	1
オモラシ	실금	1
おやすみのキス	잘자요 키스	1
おやすみの日	쉬는 날	1
オルタネイティヴ	얼터너티브	1
オンスケジュール	온스케줄	1
オリエンタル	오리엔탈	1
おんなごころ	여자 마음	1
お見送り	전송	1
お届け物	전달물	1
お漏らし	실금	1
お隣さんづきあい	이웃교제	1
お馬さんごっこ	말타기놀이	1
お目汚し	안구테러	1
お返事	회답	1
お腹回り	배 둘레	1
お愛想	겉치례	1
お情け	자비	1
お釣り銭	거스름돈	1
お昼寝	낮잠	1
お姫様だっこ	공주님 안기	1
お姫様抱っこ	공주님 안기	1
お休みの挨拶	잘 자요의 인사	1
お休みの日	쉬는 날	1
ガーゼ	거즈	1
ガーター	가터	1
ガード	가드	1
カーリングエンジェルス	컬링엔젤스	1
カイロプラクティック	카이로프래틱	1
カウパー	쿠퍼	1
カキ氷	빙수	1
かぎ爪	갈고리손톱	1
カクゴ	각오	1
カクレンボ	숨바꼭질	1
かくれんぼ	숨바꼭질	1
カケラ	파편	1
カゴメカゴメ	숨바꼭질	1
カセットコンロ	휴대용버너	1
カタコリ	어깨결림	1
カタストロフィ	캐타스트로피	1
カタマリ	덩어리	1
カチコミ	쳐들어감	1
ガチンコ	진검승부	1
ガニ股	O형 다리	1
カボチャ頭	호박머리	1
カミングスーン	커밍순	1
カモフラージュ	캐모플라지	1
カラクリ	장치	1
カラスの行水	고양이 세수	1
がらんどう	텅 빔	1
カラ笑い	헛웃음	1
カリオストロ	칼리오스토르	1
ガレオン	갈레온	1
カンシャ	감사	1
カントリー	컨트리	1
カンペ	큐 카드	1
ガン見	뚫어지게 봄	1
キィック	킥	1
キープ	킵	1
キオク	기억	1
キオクソウシツゥ	기억상실	1
キセイジジツ	기정사실	1
きそうてんがい	기상천외	1
キットカット	킷켓	1
キマリ	결정	1
キモチ	기분	1
ギャグボール	재갈볼	1
ギャグマンガ	개그만화	1
キャッシュカード	캐쉬카드	1
キャディラック	캐딜락	1
キャバクラ	캬바쿠라	1
キャメロン	카메론	1
ギャルゲ	걸게임	1
キューティ	큐티	1
キョーミ	흥미	1
ギリセーフ	아슬아슬 세이프	1
ギロチン	길로틴	1
キンチョー	긴장	1
きんつば	킨츠바	1
クィックセーブ	퀵세이브	1
クィン	퀸	1	//가타카나 발음을 위한 것
クウォークス	쿼크스	1
クールフェイス	쿨페이스	1
グゥレィト	그레이트	1
クグツ	꼭두각시	1くずきり	쿠즈키리	1
クズッ	쓰레기	1
クソゲー	쿠소게임	1
くそ度胸	똥배짱	1
グッジョブ	굿잡	1
くらいまっくす	클라이막스	1
クラストップ	클래스톱	1
すとっぷ	스톱	1
クリア	클리어	1
クリアッ	클리어	1
クリーム	크림	1
クリエイト	크리에이트	1
クリック	클릭	1
クリッスマーッス	크리스마스	1
クリティカル	크리티컬	1
グリム	그림	1	//가타카나 발음을 위한 것
グレートブリテン	그레이트 브리튼	1
クローゼット	클로젯	1
ケイケン	경험	1
ゲームセッ	게임셋	1
ケシズミ	숯	1
ケジメ	구별	1
ケッコン	결혼	1
ケッサク	걸작	1
けってーい	결-정	1	//「じゃ、けってーい！　行こ、行こ、リエのお兄ちゃん♪」
ゲテモノ	조잡한 물건	1
ケムリ	연기	1
ゲンカ	싸움	1
ゲンナリ	짜증	1
コインロッカー	코인 락커	1
コウビ	교미	1
ゴーカート	고카트	1
ゴースト	고스트	1
コクハク	고백	1
ココロ	마음	1
ゴコロ	마음	1
コタツ	코타츠	1
ごちゃ混ぜ	뒤섞인 덩어리	1
ごっこ遊び	흉내놀이	1
こっぱみじん	산산조각	1
ことの次第	일의 형편	1
コネクション	커넥션	1
コネクタ	커넥터	1
コネクト	커넥트	1
コボルト	코볼트	1
コマーシャル	커머셜	1
ゴマカシ	속임수	1
コマ落とし	빨리감기	1
コメット	코멧	1
ゴルド	골드	1
これっきり	이것 뿐	1
コンクール	콩쿠르	1
コンクリートブロック	콘크리트 블록	1
コンクル	콩쿨	1
コンセプト	컨셉	1
コンティニュー	컨티뉴	1
コンバージョン	컨버전	1
コンバート	컨버트	1
コンバット	컴뱃	1
コンパニオン	컴퍼니언	1
コンパルソリ	컴펄서리	1
コンプリート	컴플릿	1
コンプレッサー	컴프레셔	1
コンボ	콤보	1
ご構いなし	상관없음	1
ご用心	주의	1
サイアク	최악	1
サイコー	최고	1
サイレーン	사이렌	1
サシで勝負	맞장승부	1
ザッハトルテ	자허토르테	1
サドル	새들	1
サブジェクト	서브젝트	1
サボタージュ	사보타지	1
サボリ	농땡이	1
サムズアップ	썸업	1	//サムズアップしてみせる。
サラきん	융자금	1
サラ金	융자금	1
サルファ	사르파	1
サルベージ	샐비지	1
サンオイル	썬오일	1
サンクチュアリ	생츄어리	1
さんせーい	찬성	1
サンダー	썬더	1
サンドバック	샌드백	1
ざんばらの髪	산발한 머리	1
シアトリズム	시어터리즘	1
シード	시드	1
シェイク	쉐이크	1
シェイド	쉐이드	1
ジェントル	젠틀	1
シガラミ	얽매임	1
シキタリ	관습	1
シグルイ	시구루이	1
シゴキ	잡아당김	1
しっぱ～い	실~패	1
シツレー	실례	1
シナモン	시나몬	1
シノプス	시놉스	1
シボ	잔주름	1
シャーペン	샤프	1
ジャスティス	저스티스	1
シャットダウン	셧다운	1
シャッフル	셔플	1
ジャマ	방해	1
ジャンク	정크	1
ジャンケンポンッ	가위바위보	1
シュウリョ	종료	1
しゅっぱ～つ	출~발	1
ジョウロ	물뿌리개	1
ジョーカー	조커	1
ジョーダン	농담	1
ジョギング	조깅	1
ジョッキ	맥주잔	1
しわ	주름	1
しわざ	소행	1
シンニュウ	침입	1
シンパシィ	sympathy	1
ジンマシン	두드러기	1
スイーツ	스위트	1
スィート	스위트	1
スーパーバイキング	슈퍼바이킹	1
すきゃんだる	스캔들	1
スクリュー	스크류	1
スゴ腕	굉장한 솜씨	1
スタ～ト	스타~트	1
スターダスト	스타더스트	1
スッカラカン	빈털털이	1
すっからかん	빈털털이	1
すっぽんぽん	알몸	1
ストーキング	스토킹	1
ストーン	스톤	1
ストリーム	스트림	1
ストレッチ	스트레치	1
ストローク	스트로크	1
スパート	스퍼트	1
スプラッタ	스플래터	1
スプリンクラー	스프링쿨러	1
スポォツ	스포츠	1
スポット	스팟	1
すましヅラ	새침한 척	1
スマホ	스맛폰	1
ズリネタ	자윗거리	1
スレイヤ	슬레이어	1
セーフッ	세이브	1
セオリー	씨어리(theory)	1
せかいせいふく	세계정복	1	//「せかいせいふくのだいいっぽ、だね」
セカンドチップ	세컨드칩	1
セっクス	섹스	1
せっくす	섹스	1
セフティ	세이프티	1
セミロング	세미롱	1
セレブ気分	유명인 기분	1
ゾウキン	걸레	1
ソウシツ	상실	1
ソウル	소울	1
ソーサー	받침접시	1
そよ風	산들바람	1
ソルジャーオブフォーチューン	솔져오브포츈	1
ソンザイ	존재	1
ターイムストープ	타임스톱	1
タイホ	체포	1
タイムラグ	타임랙	1
タイムリープッ	타임리프	1
ダイングメッセージ	다잉 메세지	1
だいいっぽ	제 1보	1	//「せかいせいふくのだいいっぽ、だね」
ダジャレ	시시한 익살	1
ダダ	다다	1	//발음
手持ちブタ	할 일이 없음	1
フテ寝	누워버림	1
ふて寝	누워버림	1
不貞寝	누워버림	1
タダ働き	무료봉사	1
ダテ眼鏡	겉멋 안경	1
がせねた	엉터리 정보	1
偽ねた	엉터리 정보	1
ダブルミスコン	더블 미스 콘테스트	1
タメ口	반말	1
ダメ出し	지적	1
だめ出し	지적	1
駄目出し	지적	1
たんじょうび	생일	1
たんじょーび	생일	1
チームカラー	팀컬러	1
チェックメイト	체크메이트	1
チカラ	힘	1
チコク	지각	1
チャーンス	찬스	1
チャイム	챠임	1
ちゃんねる	채널	1
チャンバラ	칼싸움	1
チョウアンコク	초암흑	1
チョップ	춉	1
ちょっぷ	춉	1
ツア	투어	1
ツインズ	트윈스	1
ツインテ	트윈테일	1
ツインテール	트윈테일	1
ツキモノ	부수물	1
ツッコミ	츳코미	1
ツッコム	츳코미	1
ツムジ	가마	1
ツモ	츠모	1
ツンデレ	츤데레	1
つんぼの早耳	귀머거리의 지레짐작	1
ティーカップ	티컵	1
ティーバッグ	티백	1
ディープスロート	딥스로트	1
ディスティニー	데스티니	1
ティッシュ	티슈	1
ディティール	디테일	1
ディバイダー	디바이더	1
ディバインブロック	디바인블록	1
ティンクル	트윙클	1
デエト	데이트	1
漬物石	누름돌	1
できもの	종기	1
デコピン	핑거펀치	1
デジカム	디지털캠코더	1
デジタルヴィデオカメラ	디지털 비디오카메라	1
デジャヴ	데자뷰	1
デジャブ	데자뷰	1
デジ物	디지털물	1
テッィシュ	티슈	1
デフォルメ	데포르메	1
デモンストレイション	데몬스트레이션	1
デュエル	듀얼	1
テラー	테러	1
デリート	딜리트	1
デリカシー	델리커시	1
テリトリー	테리토리	1
デリヘル	출장마사지	1
テレパスィー	텔레파시	1
テレ隠し	수줍음 감추기	1
デンキ	전기	1
デンジャラス	데인져러스	1
テンション	텐션	1
テンペスト	템페스트	1
ドアノブ	문손잡이	1
トゥ	투	1
トゥイン	트윈	1
トーサツ	도촬	1
ドール	돌	1
ドキュメント	도큐멘트	1
ドグラマグラ	도구라 마구라	1
ドタキャン	직전 취소	1
ドック	도크	1
ドッジボール	피구	1
ドッヂボール	피구	1
ドット	도트	1
ドツボ	분뇨통	1
とも綱	밧줄	1
ドライバーユニット	드라이버 유닛	1
トラバント	트라번트	1
ドラムロール	드럼롤	1
トレジャー	트레져	1
トロピカルレモネーズ	트로피컬 레모네이즈	1
ナーバス	nervous	1
ナイショ	비밀	1
ナイトメア	나이트메어	1
ナイン	나인	1
ナカ出し	질내사정	1
ナチュラルボーン	네츄럴 본	1
ナットー	나토	1
ナフキン	냅킨	1
なに食わない態度	새침한 태도	1
ナンバーディスプレイ	넘버 디스플레이	1
なんべん	몇 번	1	//なんべんとなく往復した
ニーベルング	니벨룽	1
にらめっこ	노려보기	1
ヌイグルミ	인형	1
ニケツ	동승	1
ぬめり気	미끌한 느낌	1
ネコババ	도둑질	1
ネタ元	출처	1
ネックレス	넥클리스	1
ネトゲ	넷게임	1
ネトラレ	네토라레	1
ネトリ	네토리	1
ネバーエンディング	네버엔딩	1
ノヴェル	노벨	1
ノーブラッ	노브라	1
ノゾキ	엿보기	1
ノックアウト	넉아웃	1
ノブレス	노블레스	1
ノリアクション	노리액션	1
ノリツッコミ	노리츳코미	1
ノロケ	배우자 자랑	1
ノロケ話	주책스런 이야기	1
ノンジャンル	비[非]장르	1
パーソナリティ	퍼스널리티	1
ハードコア	하드코어	1
バーニング	버닝	1
パーフェクトハーモニック	퍼펙트 하모닉	1
ハーベスト	하베스트	1
バームクーヘ	바움쿠헨	1
ハーモニック	하모닉	1
ハーレム	하렘	1
バーンジー	번지	1
ハイエンド	하이엔드	1
ハイクラス	하이클래스	1
ハイコストパフォーマンス	하이코스트 퍼포먼스	1
バイト	아르바이트	1
ハウター	하우터	1
バオバブ	바오밥	1
ハカイ	파괴	1
ハシゴ	사다리	1
ハタチ	스무살	1
バック	백	1
バックアップ	백업	1
バツグン	발군	1
パッケ	패키지	1
パッケージ	패키지	1
バッタアウッ	타자 아웃	1
バッテン	벌점	1
バット	배트	1
ハッピーエンド	해피엔드	1
ハッピーバースデー	해피 버스데이	1
ハッピバースデートゥーユー	해피 버스데이 투 유	1
ハツラツ	발랄	1
ハナシ	이야기	1
パニク	패닉	1
パニックもの	패닉물	1
ハネムーン	허니문	1
パパイア	파파야	1
ハピネス	해피네스	1
ハラキリ	할복	1
バラストタンク	밸러스트탱크	1
バリア	배리어	1
ハリセンボン	침 1000방	1
パワハラ	직장내 괴롭힘	1
ハンケチーフ	손수건	1
ハンザイ	범죄	1
バンソウコウ	반창고	1
ハンターズ	헌터즈	1
ハンデキャップ	핸디캡	1
ピアス	피어스	1
ピアッシング	피어싱	1
ピース	피스	1
ヒートアップ	히트업	1
ビールビン	맥주병	1
ヒゲ	수염	1
ひだひだ	주름들	1
ビックリカメラ	몰래카메라	1
ヒンシュク	빈축	1
ファイト	파이트	1
ファイナルファンタジ	파이널 판타지	1
ファッションショー	패션쇼	1
フィーチャリング	피쳐링	1
フィギュア	피규어	1
フイスラブ	사내연애	1
フィニッシュ	피니쉬	1
フィフティフィフティ	50 : 50	1
フェティシズム	페테시즘	1
ブカケ	부카케	1
ブザー	부저	1
ふたぁつ	둘	1
ブラごし	브라 너머	1
ブラスト	블래스트	1
プラナリア	플라나리아	1
プラネタリウム	플라네타리움	1
フリーダム	프리덤	1
ブリーフケース	서류 가방	1
ブレイカ	브레이커	1
ブレイカー	브레이커	1
ブレイジング	블레이징	1
ブレイブ	브레이브	1
フレイム	플레임	1
プレース	프레스	1
ブレード	블레이드	1
プレッシャ	프레셔	1
プレッシャー	프레셔	1
フレンドリー	프렌들리	1
フレンドリスト	프랜드 리스트	1
ブログ	블로그	1
ページ目	페이지째	1
ヘドバン	헤어밴드	1
ポインター	포인터	1
ポーション	포션	1
ホムンクルス	호문쿨루스	1
ホラー	호러	1
ホルスタ	홀스터	1
ホルスター	홀스터	1
ボンデージ	본디지	1
ボンボン	봉봉	1
マイノリティー	마이너리티	1
マジギレ	진짜 열받음	1
マジックアイテム	매직아이템	1
ますこっと	마스코트	1
マンカス	보지 각질	1
マンガ喫茶	망가킷사	1
マジョリティー	마조리티	1
ミートスパ	미트스파	1
ムーディー	무디[moody]	1
ムーンストーン	문스톤	1
ムテキ	무적	1
メタノール	메탄올	1
メテオ	메테오	1
メルアド	메일주소	1
メンタリティ	멘탈리티	1
メンテナンス	메인터넌스	1
もちつもたれつ	상부상조	1
モテ期	인기있는 시기	1
ヤケ食い	폭식	1
やぶ蛇	긁어 부스럼	1
やましこと	꺼림칙한 일	1
やらされ感	시켜지는 느낌	1
やり過ぎのきらい	너무 심한 경향	1
ユーフォーキャッチャー	인형뽑기	1
ユーフォリア	유포리아	1
ゆうわく	유혹	1
ゆーわく	유혹	1
ラヴリィ	러블리	1
ラグビ	럭비	1
ラジャ	라져	1
ラッキ	럭키	1
ラブコメ	러브코미디	1
ランドセル	란도셀	1
リアルレジェンド	리얼 레전드	1
リッパー	래퍼	1
リフレイン	리프레인	1
ルナティック	루나틱	1
レイアー	레이어	1
レヴェル	레벨	1
レヴォリューション	레볼루션	1
レジデンス	레지던스	1
レッテル	라벨	1
レパートリー	레파토리	1
ロウソク	양초	1
ローズウッド	로즈우드	1
ローテンション	로우 텐션	1
ロシアンルーレット	러시안 룰렛	1
ロッカ	로커	1
ロッカー	로커	1
ワイセツ	외설	1
ワガマ	어리광	1
ワレメ	균열	1
ワンダーランド	원더랜드	1
街頭	가두[街頭]	1
歌向き	노래 취향	1
角突撃	뿔돌격	1
脚立	접사다리	1
肝試し	담력시험	1
懇願	간원	1
甘え癖	응석부리는 버릇	1
甘え声	응석부리는 소리	1
堪え症	참을성	1
感じ方	느끼는 방법	1
坩堝	도가니	1
甘噛み	살짝 깨물기	1
甘噛	살짝 깨물기	1
あま噛み	살짝 깨물기	1
感無量	감개무량	1
甲斐性	생활력	1
強気ぶり	강한 척	1
腔内	몸속	1
岡場所	사창가	1
開脚	개각[開脚]	1
鎧衣	요로이	1
開錠	개정[開錠]	1
据え膳	차린 밥상	1
居眠り	깜빡 졸음	1
鍵型	자물쇠형	1
掲げられた額	내걸려진 간판	1	//掲げられた額には、『成由神社』と記してあった。
激サム	격하게 추움	1
激写	격사[激寫]	1
見せあいっこ	서로 보여주기	1
見せっこ	서로 보여주기	1
見た目	겉모습	1
見得	포즈[見得]	1
犬笛	호루라기	1
決壊	결궤[決壞]	1
鎌鼬	카마이다치	1
警戒体勢	경계자세	1
軽口	농담	1
軽音部	경음악부	1
驚天動地	경천동지	1
鯨型	고래모양[鯨型]	1
稽古中	연습중	1
考え方	사고방식	1
叩き台	원안	1
高見	고견	1
苦境	곤경	1
高機動	고기동	1
苦鳴	괴로운 울음	1
袴姿	하카마 차림	1
苦節	고절[苦節]	1
告知箱	통지함	1
尻振り	엉덩이 흔들기	1
苦手教科	못하는 과목	1
苦手意識	못한다는 의식	1
蹲踞の姿勢	쭈구린 자세	1
尻拭い	뒤치닥거리	1
苦況	괴로운 상황	1
骨壺	납골 항아리	1
空のペットボトル	빈 패트병	1
空の杯	빈 잔	1
共同戦線	공동전선	1
恭順	공순[恭順]	1
恐縮	황송	1
過ぎるきらい	지나친 경향	1
寡聞	과문[寡聞]	1
慣れっこ	익숙해진 일	1
関知	관여	1
光臨	광림[光臨]	1
狂夢	광몽[狂夢]	1
狂言	미친소리	1
光輝	광휘[光輝]	1
口の端	입 끝	1
口の利き方	말투	1
亀甲	귀갑	1
球根	구근[球根]	1
口端	입 끝	1
寇掠	약탈	1
久方ぶり	오랜만	1
勾配	경사[勾配]	1
口先	입 끝	1
拘束衣姿	구속의복 모습	1
権化	권화[權化]	1	//奴らは欲望の権化となるでしょう
鬼神楽	귀신락	1
貴意	귀의[貴意]	1
閨事	성교[閨事]	1
克己	극기	1
極薄	극박[極薄]	1
鈎爪	갈퀴	1
菊蕾	국화봉오리	1
菊門	국문[菊門]	1
菊座	국좌[菊座]	1
極太	극태[極太]	1
根本	근본	1
根負け	근성에 패배	1
今日明日	오늘내일	1
禁制	금지	1
禁親相愛	근친의 사랑	1
急須	사기 주전자	1
急戦	급전[急戰]	1
気の持ちよう	마음가짐	1
寄り道	들러가기	1	//他の所に寄り道する
//気遣わし気	신경쓰이는 기분	1
綺麗事	겉치레	1
饑死	기사[饑死]	1
気弱	심약[氣弱]	1
奇縁	기연[奇緣]	1
奇遇	우연	1
気疲れ	피로	1
寄合	모임	1
機嫌直し	기분전환	1
起火	기화[起火]	1
金の光	금빛	1
金の蔓	돈줄	1
金の毛	금빛 털	1
金の髪	금발	1
金木犀	금목서	1
金砂	금사[金砂]	1
男冥利	남자로 태어난 기쁨	1
男手一つ	남자손 하나	1
男心	남심[男心]	1
男漁り	남자낚시	1
南郷	난코우	1
内腿	내퇴[內腿]	1
女系	여계[女系]	1
女蕾	여뇌[女℡뇌]	1	//후처리에서 _뇌_ -> 蕾
女冥利	여자로 태어난 기쁨	1
女芯	여심[女芯]	1
女運	여복	1
女陰	여음[女陰]	1
女陰花	여음화[女陰花]	1
年嵩	연상	1
年長	연장	1
悪乗り	덩달아 분위기 타기	1
怒濤	노도	1
怒張	노장[怒張]	1
脳みそ	뇌수	1
悩み事	고민스런 일	1
悩乱	뇌란[惱亂]	1
尿瓶	요강	1
尿意	오줌 마려움	1
泥よけ	흙받이	1
泥船	이선[泥船]	1
泥除け	흙받이	1
茶番	촌극	1
茶番劇	촌극	1
多幸	다행	1
短慮	짧은 생각[短慮]	1
当たり外れ	적중과 빗나감	1
大あくび	큰 하품	1
大はやり	대유행	1
大間違い	큰 실수	1
大剛	대강[大剛]	1
大降り	많이 쏟아짐	1
大開脚	대개각[大開脚]	1
大股開き	다리를 크게 벌림	1
大橋	대교	1
大乱闘	대난투	1
大流氷	대유빙[大流氷]	1
大満足	대만족	1
対美少女	대 미소녀	1
大迷惑	대민폐	1	//大迷惑ですっ！
大変仲	대단한 사이	1
大三角	대삼각	1
大箱	큰 상자	1
魔方陣	마방진	1
大上段	대상단[大上段]	1
大勢力	대세력	1
大手	큰 손	1
大時計	대시계	1
大岩	대암[大岩]	1
大人数	많은 사람	1
大任	대임[大任]	1
大前進	대전진	1
大正解	정답	1
大進歩	대진보	1
大草原	대초원	1
大治療	대치료	1
大捕物	대대적인 범인체포	1
大嘘	큰 거짓말	1
大協力	대협력	1
大好物	좋아하는 것	1
大和	야마토	1
大火炎	대화염	1
道難	도난[道難]	1
島中	도중[島中]	1
倒錯	도착[倒錯]	1
倒錯症	도착증	1
毒見	독견[毒見]	1
毒舌	독설	1
働き盛り	한창 일할 나이	1
動悸	심장의 두근거림	1
同意見	같은 의견	1
疼痛	동통[疼痛]	1
臀部	둔부	1
遁走	도주	1
得意との事	특기라는 일	1	//聖なる民を模すのがとりわけ得意とのこと。
登城	등성[登城]	1
登坂力	등판력	1
落日	석양	1
乱心	난심[亂心]	1
狼藉	행패	1
来船	내선	1
来院	내원	1
良案	양안[良案]	1
涼風	산들바람	1
諒解	양해[諒解]	1
呂律	말씨	1
麗花	아름다운 꽃	1
力業	힘쓰는 일	1
霊力	영력	1
霊体	영체	1
零点	영점	1
霊症	영증	1
例え話	비유적인 이야기	1
露見	노견[露見]	1
露顕	노현[露顯]	1
聾の早耳	귀머거리의 지레짐작	1
籠城	농성	1
朧衆	오보로슈	1
滝行	폭포수행	1
柳絮	버들가지	1
流儀	법식	1
流鏑馬	야부사메	1
離れ技	곡예	1
離れ業	곡예	1
裏生地	안감	1
離縁	이연[離緣]	1
理致	이치	1
裏布	안감	1
隣同士	이웃끼리	1
立ち消え	흐지부지	1
立ち位置	서는 위치	1
立ち姿	서있는 모습	1
魔糸	마실[魔絲]	1
馬房	마방[馬房]	1
馬上	마상	1
魔悦	마열[魔悅]	1
魔翼	마익[魔翼]	1
鰻登り	자꾸 올라감	1
万倍	만배	1
満悦	만열[滿悅]	1
亡き後	사후	1
妄想癖	망상벽	1
//亡骸	망해[亡骸]	1
埋み火	숯불	1
呆れ顔	기막힌 얼굴	1
毎晩	매일밤	0
妹心	여동생의 마음	1
買出し	구매	1	//俺は明日の弁当の買出しに行ってくるから、
萌え度	모에도	1
猛暑日	무더운 날	1
糸クズ	솜털	1
糸玉	실타래	1
面倒見	보살핌	1
面白解答	재미있는 해답	1
命びろい	구사일생	1
命乞い	목숨구걸	1
冥府魔道	명부마도	1
名残	여운	1
酩酊	만취	1
毛糸	털실	1
毛玉	보풀	1
目くばせ	눈짓	1
木っ端	나무 부스러기	1
目の毒	눈의 독[目の毒]	1
睦み言	정담	1
木枝	나뭇가지	1
猫用	고양이용	1
無感心	무감심[無感心]	1
無礼講	예의 안 따지는 자리	1
無理筋	무리수	1
無理心中	동반 자살	1
無作法	버릇없음	1
無駄足	헛걸음	1
聞きよう	듣는 방법	1	//フィーナがそう言うならこれ以上聞きようも無かった。
聞き上手	잘 들어주는 타입	1
聞き様	듣는 방법	1	//フィーナがそう言うならこれ以上聞きようも無かった。
文面	글내용	1
文武両道	문무양도	1
米袋	쌀부대	1
未來	미래	1
味蕾	미뢰	1
米粒	쌀알	1
未発達	미발달	1
美声	미성[美聲]	1
未習得	미습득	1
媚薬効果	미약효과	1
味玉	아지다마[味玉]	1
美人局	미인계	1
米一粒	쌀 한톨	1
眉唾	수상한 것	1
迷惑料	민폐비	1
媚花	요염한 꽃	1
ネタばれ	네타바레	1
一揃い	한 세트	1
蜜裂	밀열[蜜裂]	1
蜜涙	밀우[蜜淚]	1
蜜壺	밀호[蜜壺]	1
泊まり込み	숙박	1	//急な出張や泊まり込みが多い母さんは
縛られ通し	묶여진채	1
泊り込み	숙박	1	//急な出張や泊まり込みが多い母さんは
泊まりがけ	숙박 포함	1	//遠くに泊まりがけで旅行して
泊まり掛け	숙박 포함	1	//遠くに泊まりがけで旅行して
薄壁	박벽[薄壁]	1
薄生地	얇은 옷감	1
薄闇	얕은 어둠	1
薄暗闇	얕은 어둠	1
薄紙	얇은 종이	1
薄布	박포[薄布]	1
返り討ち	역관광	1
半家出	반가출	1
半眼	반쯤 뜬 눈	1
反応炉	반응로	1
返討ち	역관광	1
放棄	방폐[放棄]	1
放屁	방귀	1
翻方向音痴	방향치	1
白銀	백은	1
背もたれ	등받이	1
背凭れ	등받이	1
排便	배변	1
白光	백광[白光]	1
翻弄	번롱[飜弄]	1
罰当たり	벌을 받음	1
罰当り	벌을 받음	1
変わり様	바뀐 모습	1
兵糧	군량	1
併走	병주[倂走]	1
並走	병주[竝走]	1
変名	가명	1
保持	보유	1
普通科	보통과	1
腹ごしらえ	배를 채워둠	1	//ちょっと腹ごしらえしとくか。
腹上死	복상사	1
本調子	정상 컨디션	1
僕的	개인적	1
腹拵え	배를 채워둠	1	//ちょっと腹ごしらえしとくか。
缶ケリ	깡통차기	1
腐れ外道	썩은 외도	1
不見識	분별없음	1
不登校	등교 거부	1
不摂生	폐인생활	1
不信のきらい	불신의 경향	1
不安の種	불안의 씨앗	1
夫人ヅラ	부인 행세	1
不作法	버릇없음	1
不正解	오답	1
鮒鮨	후나즈지	1
父親似	아버지와 닮은 꼴	1
部活動	부활동	1
糞度胸	똥배짱	1
分銅	저울추	1
分銅つき鎖	저울추 달린 사슬	1
非の打ち所	나무랄 곳	1
飛びっ切り	최상	1
鼻歌交じり	콧노래를 부름	1	
秘口	비구[秘口]	1
秘窟	비굴[秘窟]	1
非道	비도[非道]	1
非道徳	비도덕	1
秘洞	비동[秘洞]	1
飛来	비래[飛來]	1
肥溜め	똥구덩이	1
屁理屈	억지소리	1
鼻毛	콧털	1
秘部	비부[秘部]	1
秘部弄り	비부[秘部] 장난	1
卑語	비어[卑語]	1
鄙語	비어[鄙語]	1
秘奥	비오[秘奧]	1
秘奥義	비오의[秘奧義]	1
非人間的	비인간적	1
非人格的	비인격적	1
非人道	비인도	1
秘膣	비질[秘膣]	1
飛車角	히샤카쿠	1
秘処	비처[秘處]	1
秘花	비화[秘花]	1
贔屓	편애	1	//후처리의 필요성...?贔屓が多い
牝情	빈정[[牝情]	1
牝恥	빈치[牝恥]	1
思いのたけ	더없는 마음	1	// 思いの丈
四つん這い	네발로 엎드림	1
四つ這い	네발로 엎드림	1
捨て台詞	일방적인 대사	1
砂嵐	모래폭풍	1
四六時中	온종일	1
四歩	네 걸음	1
些事	사소한 일	1
仕事柄	일 관계상	1
思案中	생각 중	1
私怨	개인적 원한	1
射乳	사유[射乳]	1
死合	시합[死合]	1
殺戮	살육	1
産毛	솜털	1
三歩	세 걸음	1
三人四脚	3인4각	1
上がり框	문턱	1
上目づかい	눈을 치켜뜸	1
賞味	상미[賞味]	1
相思相愛	상사상애	1
上新粉	멥쌀가루	1
生きり	생존	1
商会	상회	1
生竿	생간[生竿]	1
生徒会	학생회	1
生贄	제물	1
西の地平	서쪽의 지평	1
石鍋	돌솥	1
石橋	돌다리	1
石床	돌바닥	1
石化	석화	1
船底	선저	1
宣伝文句	선전문구	1
舌なめずり	입맛을 다심	1
舌の先端	혀 끝	1
舌弄	혀장난	1
譫言	헛소리	1
性関係	성관계	1
星芒	별빛	1
性癖	성벽	1
聖夜	성야	1
性活	성활	1
蛻の殻	빠져나간 껍질	1
もぬけのから	빠져나간 껍질	1
世間的	세속적	1
歳上	연상	1
細針	가는바늘	1
細波	잔물결	1
容れ物	용기	1
世話焼き	남의 일에 신경씀	1
世話焼きぶり	오지랖 떠는 모습	1
焼けた鉄	달궈진 철	1
小躍り	덩실거림	1
掻痒	소양[搔痒]	1
所有物	소유물	1
焼印	낙인	1
素振り	기색	1
松明	횃불	1
送迎	송영[送迎]	1
受け皿	받침접시	1
手のひらの震え	손의 떨림	1
手の平の震え	손의 떨림	1
手みやげ	작은 선물	1
数度目	몇 번째	1
手篭め	괴롭힘	1
修理代金	수리대금	1
藪蛇	긁어 부스럼	1
穂先	끝	1
獣性	수성[獸性]	1
水地形	물 지형	1
受信元	수신원	1
収獲	수확	1
熟鮓	나레즈시	1
巡り合せ	운명	1
巡り合わせ	운명	1
めぐり合わせ	운명	1
巡り会せ	운명	1
巡り会わせ	운명	1
めぐり会わせ	운명	1
順番	순번	1
仕事納め	종무	1
旬外れ	한물감	1
術式	술식	1
術中	술중	1
虱潰し	철저히 뒤짐	1
膝裏	무릎 뒤	1
膝元	슬하	1
習い事	배우는 일	1
升麻	승마[升麻]	1
縄張り争い	세력 싸움	1
視姦	시간[視姦]	1
時期はずれ	시기 벗어남	1
時期外れ	시기 벗어남	1
示談	합의	1
矢先のこと	순간의 일	1
食い扶持	생활비	1	//「ただの仕事だ、食い扶持は誰でも必要だろう？」
息一つ	숨 하나	1
神代	신대[神代]	1
新館	신관	1
神力	신력[神力]	1
身売り	몸팔이	1
神武	진무[神武]	1
神武寺	진무지	1
新部室	레벨	1
辛酸	쓰라림	1
神楽舞	굿춤	1
実年齢	실연령	1
実活動	실활동	1
心配事項	걱정사항	1
心配性	걱정 많은 성격	1
心身一体	심신일체	1
心意気	마음가짐	1
十里	10리	1
十数年	십수년	1
辻演説	가두연설	1
双つ	두개	1
桜風	벚꽃 바람	1
桜雲	벚꽃 구름	1
愛故	애고[愛故]	1
安眠	안면[安眠]	1
桜吹雪	벚꽃 눈보라	1
鸚鵡返し	앵무새 흉내	1
厄介事	귀찮은 일	1
岸壁	안벽[岸壁]	1
安月給	박봉	1
顔前	안전[顔前]	1
暗たん	암담	1
暗闇	어둠	1
闇夜	암야[闇夜]	1
//灯籠	등롱	1
闇雲	암운[闇雲]	1
夜伽	밤시중	1
夜毎	밤마다	1
出来レース	담합 레이스	1
薬袋	약 주머니	1
夜這い	요바이	1
夜天	밤하늘	1
野晒し	들에 버려짐	1
御伽噺	옛날 이야기	1
御構いなし	상관없음	1
//御心	마음	1
御言葉	말씀	1
御意志	의지	1
御行幸	행차	1
言霊	언령	1
彦星	견우성	1
言葉のあや	멋진 표현	1	//言葉のあやですわ。
俺用	내 전용	1
俺好み	내 취향	1
余熱	여열[余熱]	1
縁筋	연줄	1
悦痺れ	기쁨의 저림	1
染み一つ	얼룩 한 점	1
鋭痛	예통[銳痛]	1
奥壁	안벽	1
五歩	다섯 걸음	1
汚棒	오봉[汚棒]	1
五体満足	오체만족	1
五位	5위	1	//五位
完徹	완전 철야	1
腕枕	팔 베게	1
矮小化	왜소화	1
拗ねた表情	토라진 표정	1
揺り籠	요람	1
揺り籃	요람	1
揺籠	요람	1
腰布団	포대기	1
雲泥の差	하늘과 땅 차이	1
右向け右	우향우	1
右前	좌전[右前]	1
鬱屈	울적	1
元宮廷	원 궁정	1
元中尉	원 중위	1
遠吠え	멀리서 짖음	1
月謝	수업료	1
癒やし	치유	1
濡れ染み	젖은 얼룩	1
幼少	유소[幼少]	1
月謝金	수업료	1
危惧	위구[危懼]	1
有刺鉄線	가시철선	1
乳切木	유절목[乳切木]	1
肉茎	육경[肉莖]	1
乳搾り	젖짜기	1
肉塊	고깃덩이	1
肉交	육교[肉交]	1
肉溝	고기틈	1
肉洞	육동[肉洞]	1
肉豆	고기콩	1
肉裂	고기틈	1
肉蕾	육뇌[肉℡뇌]	1	//후처리에서 _뇌_ -> 蕾
肉瘤	육류[肉瘤]	1
肉粒	고기 알갱이	1
肉襞	고깃주름	1
肉床	고기바닥	1
肉線	육선[肉線]	1
肉室	육실[肉室]	1
肉芯	육심[肉芯]	1
肉便器	육변기	1
肉膣	육질[肉膣]	1
肉筒	육통[肉筒]	1
肉芽	육아[肉芽]	1
肉圧	육압[肉壓]	1
隠し扉	숨겨진 문	1
淫辞	음탕한 말	1
意念	의념	1
//疑念	의념[疑念]	1
衣擦れ	옷스침	1
耳ざわり	귀에 거슬림	1
二の次	둘째	1
二口	두입	1
伊達姿	겉멋부린 모습	1
二歩	두 걸음	1
餌付け	길들임	1	//餌付けする (えづけ)
異常性癖	이상성벽	1
二十四時間	24시간	1
耳障り	귀에 거슬림	1	//耳ざわりな声
異存	이의	1
以下略	이하 생략	1
耳穴	귓구멍	1
二穴	두 구멍	1
人間業	인간의 재주	1
引金	방아쇠	1
人馬一体	인마일체	1
人払い	주위 사람을 없게 함	1
人域超越	인역초월	1
仁王立ち	고압적인 자세	1
引込み思案	숫기가 없음	1
忍従	인종[忍從]	1
一つや二つ	하나나 둘	1
日光	일광	1
日光除け	햇볕차단	1	//日光除けにと知由が用意してくれた日傘も、
一球一殺	일구일살[一球一殺]	1
一気飲み	단숨에 마시기	1
一覧表示	일람표시	1
一縷	한 가닥	1
一粒万倍	일립만배[一粒万倍]	1
一糸	한가닥의 실	1
逸物	일물[逸物]	1
一瞥	일별[一瞥]	1
一歩二歩	한 걸음 두 걸음	1
一夫一妻	일부일처	1
日射	햇살	1 
日射し	햇살	1
一仕事	한가지 일	1
一閃	일섬[一閃]	1
一世一代	일생일대	1
日数	일수	1
一矢一殺	일시일살	1
一雨	한바탕 비	1	//もう一雨来そうな予感がする。
一揉み	한번 주무름	1
一条の光	한 줄기의 빛	1
一条の光明	한 가닥의 광명	1
一周り	한 바퀴	1
一周り年上	12살 연상	1
一周り年下	12살 연하	1
一芝居	연극	1
一陣	일진[一陣]	1
一振り	한번 휘두름	1
一匹二匹	한마리 두마리	1
一喜一憂	일희일비	1
入水	입수	1
雌伏	자복[雌伏]	1
自分探し	자기자신 찾기	1
姉心	언니의 마음	1
自意識過剰	자의식과잉	1
自主練	자율연습	1
自主練習	자율연습	1
雌化	암컷화	1
腸腔	장강[腸腔]	1
腸管	장관[腸管]	1
再構成	재구성	1
佇まい	분위기	1	//풍취
猪口	술잔	1
低頭	머리를 숙임	1
咀嚼	저작[咀嚼]	1
赤豆	붉은콩	1
覿面	직방	1
赤線	붉은 선	1
前屈姿勢	앞으로 굽힌 자세	1
全寮制	전원 기숙사제	1
全体重	전체중	1
前非	지난 잘못	1
戦渦	전와[戰渦]	1
前人未到	전인미답	1
前程	전정[前程]	1
折り紙付き	확실히 보증함	1
絶句	절구[絶句]	1
切先	칼끝	1
静観	정관[靜觀]	1
正夢	정몽[正夢]	1
町並み	거리풍경	1
町歩き	마을 산책	1	//町歩きは楽しかったけど、今までの疲れもたっぷりと溜まってる。
釘付け	못박음	1
正史	정사	1
正三角	정삼각	1
朝昼	아침 점심	1
梃子	지렛대	1
弟的存在	남동생적 존재	1
誂え向き	안성맞춤	1
早とちり	지레짐작	1
照れ隠し	수줍음 감추기	1
鳥居	신사 기둥문	1
朝練	아침연습	1
嘲弄	조롱	1
朝勃ち	아침발기	1
早弁	도시락 까먹기	1
調伏	조복[調伏]	1
彫像	조각상	1
爪先	발끝	1
早数日	벌써 며칠	1
早耳	빠른 귀[早耳]	1
朝日	아침해	1
足留め	발이 묶임[足留め]	1
足留め策	발을 붙잡을 방책	1
足先	발끝	1
足止め	발이 묶임[足止め]	1
足止め策	발을 붙잡을 방책	1
縦筋	세로선[縱筋]	1
縦長	종장[縱長]	1
注挿	삽입질	1
呪詛	저주	1
注ー目	주-목	1
左前	우전[左前]	1
左向け左	좌향좌	1
噂話	소문	1
中イキ	질내사정	1
重光線	중광선	1
中途半端	애매함	1
重武装	중무장	1
重装備	중장비	1
即戦力	즉시전력	1
蒸しタオル	찐 수건	1
指の腹	손가락 안쪽	1
舐めた視線	깔보는 시선	1	//女共はチラッとコッチを見て舐めた視線を向ける。
舐めた態度	깔보는 태도	1	//浮気して舐めた態度を取る嫁に復讐してやった。
指姦	지간[指姦]	1
知己	지기	1
指弄	손장난	1
指弄り	손장난	1
至宝	지보[至寶]	1
指腹	손가락 안쪽	1
紙束	종이다발	1
紙玉	종이구슬	1
地獄耳	지옥귀[地獄耳]	1
職務放棄	직무태만	1
直伝	직전[直傳]	1
姫蕾	희뇌[姬℡뇌]	1	//후처리에서 _뇌_ -> 蕾
真名	본명	1
真相究明	진상규명	1
姫肉蕾	희육뇌[姬肉℡뇌]	1	//후처리에서 _뇌_ -> 蕾
鎮魂	진혼	1
姫花	희화[姬花]	1
珍種	진종[珍種]	1
膣口	질구[膣口]	1
膣内出し	질내사정	1
膣道	질도[膣道]	1
膣洞	질동[膣洞]	1
膣中射精	질내사정	1
膣襞	질벽	1
磔状態	묶인 상태	1
察知	짐작	1
隻眼	애꾸눈	1
天変地異	천재지변	1
泉源	천원[泉源]	1
千摺り	용두질	1
天誅	천주[天誅]	1
天下御免	천하공인	1
鉄の棒	철봉	1
鉄格子	쇠창살	1
鉄杭	쇠말뚝	1
添乗	수행안내	1
清涼感	청량감	1
青痣	푸른 멍	1
清濁	청탁[淸濁]	1
諦観	체관[諦觀]	1
躰全部	신체 전부	1
躰全体	신체 전체	1
草むしり	풀뽑기	1
初見	초견[初見]	1
初対面	첫대면	1
草毟り	풀뽑기	1
初物	초물[初物]	1
初任務	첫 임무	1
総司令	총사령	1
初出勤	첫 출근	1
最高の出来	최고의 성과	1
触りっこ	만지기	1
追いかけっこ	술래잡기	1
推力	추력	1
抽送	삽입질	1
抽迭	삽입질	1
出だし	첫시작	1
出家	출가	1
出掛け中	외출중	1	//公爵様はお出かけ中でございます
出立	출발	1
出世の蔓	출세의 연줄	1
出自	출신	1
出出し	첫시작	1
臭跡	냄새 흔적	1
側溝	배수로	1
側道	샛길	1
歯噛み	이를 갊	1
恥垢	치구[恥垢]	1
恥裂	치열[恥裂]	1
歯磨	양치질	1
恥声	치성[恥聲]	1
歯軋り	이를 갊	1
熾火	숯불	1
親離れ	자립	1
親切心	친절한 마음	1
七星石	칠성석	1
七転八倒	칠전팔도[七轉八倒]	1
寝物語	잠자리에서의 이야기	1
針先	바늘 끝	1
浸潤	침윤[浸潤]	1
浸入	칩입	1
寝姿	자는 모습	1
快美	쾌미[快美]	1
誕生花	생일꽃	1
誕生会	생일파티	1
脱兎	도망가는 토끼	1
蕩け視線	녹은 시선	1
湯治	온천요양	1
太幹	태간[太幹]	1
駄目元	밑져야 본전	1
駄洒落	어설픈 익살	1
駄駄	응석	1
土産物	토산물	1
土埃	흙먼지	1
土足	흙발	1
退屈凌ぎ	심심풀이	1
破れかぶれ	자포자기	1
破瓜	파과[破瓜]	1
波濤	파도	1
判子	도장	1
八つあたり	화풀이	1
八つ当たり	엉뚱한 화풀이	1
片時	잠시	1
鞭打ち	채찍질	1
平安	평안	1
閉じ気味	닫힌 기색	1
捕り物	범인체포	1
披露	피로[披露]	1
披露目	피로[披露目]	1
疲労困憊	기진맥진	1
披露宴	피로연	1
筆下ろし	동정깨기	1
下ネタ	저질 이야기	1
何鍋	무슨 냄비	1
何鍋目	몇 냄비째	1
何巻	몇권	1
何食わない態度	새침한 태도	1
何段	몇단	1
何人当たり	몇 인당	1
夏休み	여름방학	1
何味	무슨 맛	1
何座	무슨 자리	1
何杯	몇잔	1
閑話休題	한화휴제	1
合わせ目	이음새	1
合点	납득	1
肛姦	항간[肛姦]	1
肛虐	항학[肛虐]	1
解呪	해주[解呪]	1
海風	해풍	1
行かれた話	얼빠진 이야기	1
行末	행말[行末]	1
血だまり	피 웅덩이	1
香草	향초	1
頬ずり	뺨 비비기	1
嘘辨明	거짓 변명	1
頬擦り	뺨 비비기	1
挟射	슴가섹스[狹射]	1
嘘寝	거짓잠	1
好感触	좋은 느낌	1
呼鈴	초인종	1
湖面	호수면	1
豪遊	호유[豪遊]	1
好印象	좋은 인상	1
胡座	책상다리	1
もぬけの空	빈 껍질	1
魂胆	꿍꿍이	1
渾然一体	혼연일체	1
惚気	배우자 자랑	1
紅蕾	붉은 꽃봉우리	1
哄笑	홍소[哄笑]	1
火蓋	화약뚜껑	1
花道	화도	1
火伏せ	화제 방지	1
花珠	꽃 진주	1
花唇	화순[花唇]	1
確執	갈등	1
丸わかり	뻔히 보임	1	//自らの利益を守ろうと必死なのが丸わかりだ
荒縄	밧줄	1
悔し気	분한 기분	1
回り合せ	운명	1
回り合わせ	운명	1
胸元	가슴팍	1
会話らしい会話	회화다운 회화	1
横倒し	옆으로 쓰러짐	1
横穴	횡혈[橫穴]	1
後ろ髪	뒷머리	1
厚意	후의[厚意]	1
後漢朝	후한조	1
喧噪	소란함	1
虫取り	벌레잡이	1
虫唾	신물	1
胸板	가슴판	1
黒翼	검은 날개	1
黒板	칠판	1
黒革	검은 가죽	1
屹立	흘립[屹立]	1
欠き氷	빙수	1
希望の種	희망의 씨앗	1
折り畳み	접이	1
電柱	전봇대	1
念押し	거듭한 다짐	1
ミスタイプ	오타	1
オーバードース	과다복용	1
愛想尽かし	정떨어짐	1
撮影機能	촬영기능	1
見せ筋	미끼	1
ポンコツ	폐품	1
スリープ	슬립	1	//카타 발음을 위해 추가 : サイレントスリープ
電脳	전뇌	1	//ほらほら、あの電脳少女ミクちゃんだよ
眠気覚まし	졸음쫒기	1	//眠気覚ましのドリンクがバリバリ効いていた。
へどろ	진흙탕	1	//丁寧な言葉でも中身はドロッドロのヘドロね
何泊	몇 박	1	//ホテル代くらいは出せるけど……何泊もは正直きつい。
イージー	이지	1	//카타 발음을 위해 추가
山遊び	산놀이	1
ハーヴェスト	하베스트	1
シンギュラリティ	Singularity	1
騎体性能	기체성능	1
心甲一致	심갑일치	1
探査機能	탐사기능	1
天下布武	천하포무	1
合戦礼法	합전예법	1
無垢	무구	1
生類哀れみの令	살생금지령	1	//♞生類憐れみの令
役職	직위	1
禄高	녹봉	1
影踏み	그림자 밟기	1
江戸詰め	에도에서 근무	1
感応能力	감응능력	1
楽勝	낙승	1
//縁起	조짐	1	//안 건드리는게 좋을 것 같다...
猫の額	고양이 이마	1
女座り	여성스런 앉기	1
女の子座り	여자아이 앉기	1
すぺしゃる	스페셜	1
ヒ・ミ・ツ	비·밀	1
ニホンゴ	일본어	1
マボロシ	환상	1
夏の始まり	여름의 시작	1
一押し	한번 밀기[一押し]	1	//最後の一押しが無いとあたし激サムじゃん！
戦いの火蓋	전투의 포문	1
夜の物語	밤의 이야기	1	//甘く切ない夜の物語が幕を開けるのだった
四万年	4만년	1
アクシツ	악질	1
あくしゅ	악수	1
アイスバニッシャー	아이스 배니셔	1
魔法円	마법진	1	//つまりその魔法円は間違えている…？
希臘語	희랍어	1
神名	신명[神名]	1
グリッド	그리드	1
一日千秋	일일천추[一日千秋]	1	//一日千秋とお待ちしておりますわ
ジャンクション	정션	1
オーシャンズ	오션스	1
関の山	고작	1	//からかわれるくらいが関の山です
//不精	부정[不精]	1
アダファルス	아다파르스	1
アスタロト	아스타로트	1
賽銭箱	새전함[賽錢箱]	1
誉め言葉	칭찬하는 말	1	//誉め言葉だと思っとくよ
あてんしょん	어텐션	1
収束	수속[收束]	1
頭頂	정수리	1
顔一つ	얼굴 하나	1
あやとり	실뜨기	1
アリオン	아리온	1
アルチェ	아르체	1
アルディヒナ	아르디히나	1
散歩日和	산책하기 좋은 날씨	1	//お散歩日和です
然るべきもの	마땅한 것	1	//然るべきものだろう？
主菜	주채[主菜]	1
副菜	부채[副菜]	1
お世辞	겉치레말	1	//お世辞にも良くなかった
探り合い	떠보기	1	//別段腹の探り合いも必要ありませんか
腹の探り合い	속셈 떠보기	1	//別段腹の探り合いも必要ありませんか
鍔元	날밑 부분	1	//次の刹那、一瞬の間隙に刃を引くと同時にその鍔元を狙って互いの太刀が閃めく。
戸口	호구[戶口]	1
みらくる	미러클	1
薬漬け	약품 과다투여	1
いたわり	위로	1
イジめ	이지메	1
イスベル	이스벨	1	//카타카나 발음을 위한 것
たまの休み	어쩌다 있는 휴일	1
箱型	상자형	1
隙間跡	틈새자국	1
ストンピング	스톰핑	1
残照	저녁노을	1
何歩	몇 걸음	1	//何歩譲ってもパイズリだ。
針のむしろ	가시방석	1
アドリブ	애드립	1
ウエットティッシュ	물티슈	1
初経験	첫경험	1
注目の的	주목의 대상	1
養子縁組	양자결연[養子緣組]	1
その口調	그 어조	1	//その口調が信じられないほど明るくって前向きで。
バタ足	물장구	1
台所事情	가계 사정	1
七国	칠국	1
フィギュアスケート	피겨 스케이트	1
律儀	율의	1
しどろもどろ	횡설수설	1
オオゴト	큰 일	1
レジェンダリー	레전더리	1
オウンゴール	자살골	1
見えっ張り	허세부림	1
見栄っ張り	허세부림	1
特盛り	특대	1
大元	근본	1	//大元を考えてみようよ。オールオッケー	올 오케이	1
辻斬り	츠지기리[つじ斬り]	1
つじ切り	츠지기리[つじ切り]	1
エイプリルフール	만우절	1
バトミントン	배드민턴	1
目のつけどころ	착안점	1
コルシカ	코르시카	1
諸刃の剣	양날의 검	1
ノンアルコール	논알코올	1
キャプチャー	캡처	1
ニップレス	니플리스	1
ブレスレット	브레이슬릿	1
トパーズ	토파즈	1
クラシカル	클래시컬	1
フェニックス	피닉스	1
フェードイン	페이드 인	1
フェードアウト	페이드 아웃	1
シュレディンガー	슈뢰딩거	1
リヴァイアサン	리바이어던	1
カラーリング	컬러링	1
クオリア	퀄리아	1
ミョルニル	묠니르	1
パッケージング	패키징	1
バームクーヘン	바움쿠헨	1
玉に瑕	옥의 티	1
バニッシュ	배니시	1
プッシング	푸싱	1
アイアンメイデン	아이언 메이든	1
防具	방어구	1
デッドオアアライブ	데드 오어 얼라이브	1
ホールデム	홀덤	1
三すくみ	삼자견제	1
ヴァルハラ	발할라	1
昔々	옛날 옛날	1
棒立ち	우뚝선 자세	1
マグロ漁船	참치 어선	1
巨乳もの	거유물	1
目移り	눈움직임	1
半脱ぎ	반나체	1
分れ道	갈림길	1
ゴロ合わせ	연상 암기법	1
両思い	서로 사모함	1	//二人が両想いになる。じゃあ私たち、両思いで……ん……つ、付き合って……くれるの？
両想い	서로 사모함	1	//二人が両想いになる。じゃあ私たち、両思いで……ん……つ、付き合って……くれるの？
お伽噺	옛날 이야기	1
お椀	밥공기	1
淫夢	음몽[淫夢]	1
大連呼	대연호	1
付箋	포스트잇	1
棒読み	단조롭게 읽기	1	//「……姉ちゃん、棒読みになってるよ」
依怙贔屓	한쪽만 편듦	1
エコヒイキ	한쪽만 편듦	1
アダ名	별명	1
半剥け状態	반 벗겨진 상태	1
何週間振り	몇 주간만	1
来襲	내습	1
差し金	곱자[差し金]	1
八つ裂き	갈가리 찢음	1
東京	도쿄	1
つぶて	돌멩이	1
戯れ言	농담	1
ゆびきり	약속	1
コミニュケーション	커뮤니케이션	1
繁み	수풀	1
虫のしらせ	불길한 예감[蟲のしらせ]	1
虫の知らせ	불길한 예감[蟲の知らせ]	1
タロットカード	타로 카드	1
二天一流	이천일류[二天一流]	1
アクロバティック	아크로바틱	1
沸点	끓는점	1
融点	녹는점	1
氷点	어는점	1
時間の無駄	시간 낭비	1
マドレーヌ	마들렌	1
ランターン	랜턴	1
クィック	퀵	1
スカベンジャー	스캐빈저	1
器用貧乏	다재무능[器用貧乏]	1
下衆の勘ぐり	비열한 중상	1
助走	도움닫기	1
木っ端微塵	산산조각	1
羽交い締め	날갯죽지 조르기	1
板挟み	진퇴양난	1
トコシエ	영원	1
何時ぶり	얼마만	1	//他人と肩を並べるなんて何時ぶりか
手負い	상처입음	1	//手負いである白い少女にとって最も望ましい日時
ブレス	브레스	1
同い歳	같은 나이	1
少子化	저출산화	1
驚き所	놀라운 곳	1
一頭	한 마리	1	//ただ一頭か。
トゥインクル	트윙클	1
虎の尾	호랑이 꼬리	1
アイシクル	아이시클	1
チェイン	체인	1
力任せ	전력	1	//力任せで壊すのは現実的ではありません。
小影	작은 그림자	1
足場	발판	1
太刀筋	칼솜씨	1
カプセル	캡슐	1
くるせいだーす	크루세이더스	1
エスクワイア	에스콰이어	1
いろとりどり	각양각색	1
小粋	멋짐	1
ほうけた表情	얼빠진 표정	1
辞令	사령[辭令]	1	//誰だ地上担当の辞令出したの。
しゃべりかた	말투	1
喋りかた	말투	1
おひざ元	슬하	1
貫高制	관고제[貫高制]	1
おせんたくもの	세탁물	1
大食事会	대식사회	1
大食堂	대식당	1
リーダーシップ	리더십	1
好都合	안성맞춤	1
オーガズム	오르가즘	1
サポーター	서포터	1
セキュリティ	시큐리티	1
固定概念	고정관념	1
食器洗い機	식기세척기	1
ネタバレ	네타바레	1
ねたばれ	네타바레	1
脳味噌	뇌수	1
脳ミソ	뇌수	1
ぶっちゃけた話	까놓고 하는 이야기	1
立ち場	입장	1
どん引き	썰렁	1
ドン引き	썰렁	1
正義の味方気取り	정의의 편 기분내기	1
正義の味方	정의의 편	1
涙交じり	눈물 섞임	1
こどもだまし	어린애 속임수	1
こども騙し	어린애 속임수	1
子供だまし	어린애 속임수	1
子供騙し	어린애 속임수	1
身一つ	몸 하나	1
胸くそ	기분	1
むなくそ	기분	1
むねくそ	기분	1
機織	베짜기	1
これいじょう	이 이상	1
それいじょう	그 이상	1
あれいじょう	저 이상	1
なにごと	무슨 일	1
おつき合い	교제	1
しめんそか	사면초가	1	//四面楚歌 (しめんそか)
しらみつぶし	철저히 뒤짐	1	//虱潰し (しらみつぶし)
じっさい	실제	1
せんずり	용두질	1
センズリ	용두질	1
たからもの	보물	1
たてすじ	세로선[縱筋]	1
タテスジ	세로선[縱筋]	1
おだいどころ	부엌	1
脱衣かご	탈의 바구니	1
ちぎりき	몽둥이	1
一騎	일기[一騎]	1
一騎打ち	일대일 대결	1
一騎打	일대일 대결	1
ひみつ	비밀	1	//ごくごくのひみつ
ほえ面	울상	1
耳っ擦り	귓속말	1
耳っこすり	귓속말	1
太刀打	맞겨룸	1
せくはら	성희롱	1
じょーだん	농담	1
かんけー	관계	1	//かんけーねーよ。
お手伝い	거들기	1
おてつだい	거들기	1
お互いさま	피차일반	1
へっちゃら	만사태평	1
しくはっく	온갖 고통	1
しんじつ	진실	1
気やすめ	위안	1
虫かご	곤충상자	1
心頭滅却	심두멸각	1
てるてる坊主	테루테루보즈	1
照る照る坊主	테루테루보즈	1
てるてるぼうず	테루테루보즈	1
射手座	궁수자리	1
コントローラー	컨트롤러	1
長柄	긴 자루	1	//漆黒の阿吽の腕に抱かれた長柄が宙を旋回する。
にんしき	인식	1
穢土	예토[穢土]	1
大門	대문	1
リスペクト	리스펙트	1
長毛	장모[長毛]	1
スリーパー	슬리퍼	1
水飛沫	물보라	1
空容器	빈 용기	1
ぱちんこ	빠칭코	1
早歩き	빠른 걸음	1
踵落とし	내려차기	1
精神衛生	정신건강	1
オッドアイ	오드아이	1
筋肉弛緩剤	근육이완제	1
シュレーディンガー	슈뢰딩거	1
磨ぐ音	가는 소리	1	//包丁を磨ぐ音まで聞こえる。
ヒトトキ	한 때	1	//あまーいヒトトキを過ごして帰るから
エヴォリューション	에볼루션	1
ヒロイック	히어로익	1
ユニット	유닛	1
横スクロール	횡스크롤	1
無頓着	무관심	1	//恋愛事に関してはウブを通り越して無頓着。
ツイッター	트위터	1
アナザー	어나더	1
持久走	오래 달리기	1
得意種目	자신있는 종목	1
道路脇	도로 옆	1	//道路脇に停めてあった車から降りてきた。
ベーグル	베이글	1
突貫	강행[突貫]	1	//突貫で悪いけど、みんな頑張ってくれよ！
探検ごっこ	탐험놀이	1
学祭	학원제	1
ボストン茶会事件	보스턴 차 사건	1
笑い事	웃을 일	1	//笑い事じゃねーよ。
ナンバーズ	넘버스	1
ワンニャン	완냥	1	//개, 고양이의 울음소리라 함
ひと筋	한 줄기	1	//有坂さん、私たちずっとスピーダーひと筋でいましょう
ひしゃく	국자	1
とらえどころ	붙잡을 곳	1	//とらえどころのない空だった。
平和主義	평화주의	1
仮留め	임시 고정	1	//まずはピンで仮留めするところからだよ
留め鋲	압정	1
門留め	출입금지	1
ピン留め	머리핀	1
仰天	앙천[仰天]	1	//そして、待ち構えていた光景に仰天する。
敷布団	이불	1
天狗舞	텐구마이[天狗舞]	1
昼風呂	낮목욕	1
洗濯バサミ	빨래집게	1
板ばさみ	진퇴양난	1
ひなたぼっこ	햇볕쬐기	1
二言目	입버릇	1
爆睡	깊은 잠[爆睡]	1
扇状	부채꼴[扇狀]	1
暇人よばわり	한가한 사람 취급	1	//どいつもこいつも二言目には人を暇呼ばわりしやがって。
暇呼ばわり	한가한 사람 취급	1	//どいつもこいつも二言目には人を暇呼ばわりしやがって。
何語	무슨 언어	1
下世話	속된 말	1	//(x)下世話な方向の疑惑だろう……
死屍累々	시산혈해[死屍累累]	1
良薬	좋은 약	1
股割り	가랑이 찟기	1
抑え目	자제하는 편	1	//練習も抑え目に行こうかと。
屑籠	휴지통	1
大外刈り	밭다리 후리기	1
朝昼晩	아침 점심 저녁	1	//朝昼晩の食事じゃねーんだっつーの。
重低音	중저음	1
はらごしらえ	배를 채워둠	1
恐悦至極	공열지극[恐悅至極]	1
足運び	발걸음	1	//道場と同じ足運びをしていたら
だらけ癖	게으른 버릇	1
取り替えっこ	바꾸기	1
時差ボケ	시차적응	1
逆切れ	적반하장	1
別口	다른 종류	1	//別口ってことだ。
古手ぬぐい	낡은 수건	1
純粋無垢	순진무구	1
後ろ倒し	뒤로 미룸	1
余白	여백	1
轢殺	역살[轢殺]	1
ひっさしぶり	오랜만	1
半立ち	반쯤 서기[半立ち]	1
ディープキス	딥키스	1
御椀	그릇	1
立ち聞き	엿듣기	1
短き命	짧은 생명	1
仇討ち	복수	1
ばんそうこ	반창고	1
大音量	대음량	1
戦闘訓練	전투훈련	1
金目的	돈 목적	1	//金目的でも、テロでもない。
ママゴト	소꿉장난	1
鮨詰め	꽉 들어참	1
顔文字	이모티콘	1
姫様抱き枕	공주님 안기 베게	1
抱き枕	다키마쿠라	1
前段階	전단계	1
口角泡	게거품	1
万々歳	만만세	1
佳き日	경사스런 날	1
逸材	일재[逸材]	1
居住まい	앉은 자세	1
サツガイ	살해	1
シガレット	시거렛	1
来航	내항	1
ユカイツーカイ	유쾌통쾌	1
責任逃れ	책임회피	1
オマツリ	축제	1
寝取られ	네토라레	1
寝取り	네토리	1
寝違え	잘못자서 삐끗함	1
ホドホド	적당	1
バクハツ	폭발	1
大迫力	대박력	1
バンソーコー	반창고	1
味つけ	맛내기	1
ワンダホー	원더풀	1
真っ逆さま	완전히 역상[逆樣]	1	//東諒湾に真っ逆さまだという事を忘れることのなきよう。
真っ逆様	완전히 역상[逆樣]	1	//飛行機が真っ逆様に墜落する
オートマティック	오토매틱	1
食べごたえ	식감	1
ぼったくり	바가지 씌우기	1
ぼっ手繰り	바가지 씌우기	1
べっかんこ	메롱	1
べっかんこう	메롱	1
あかんべえ	메롱	1
イマドキ	요즘	1
ハラペコ	배고픔	1
夜ふかし	밤샘	1
気の使いすぎ	너무 신경 씀	1	//気の使いすぎは好ましくありません。
気の使い過ぎ	너무 신경 씀	1
いっかいだけ	한번 만	1	//いっかいだけ叶えられるんだよ
ほんすじ	본론	1	//ちょっとだけ物語のほんすじから外れた
大げんか	큰 싸움	1
顔馴染み	낯익은 사이	1
はだか	알몸	1
曇り空	흐린 하늘	1
色味	색감	1
みなごろし	몰살	1	//みなごろしにしようとする――
宙ぶらりん	엉거주춤	1	//部活に入ったのに宙ぶらりんみたいなこと。
なかまはずれ	동료제외	1
時季はずれ	계절 벗어남	1
時季外れ	계절 벗어남	1
高台	고대[高台]	1
おないどし	동갑	1
悩み所	고민거리	1
厄介ごと	성가신 일	1
寝ぼけ顔	잠에서 덜 깬 얼굴	1
雪片付け	눈치우기	1
手持ちかばん	손가방	1
的外れ	빗나감	1
休みボケ	휴일 휴우증	1
丸投げ	통째로 맡김	1
依代	의대[依代]	1
木の根	나무 뿌리	1
内股歩行	안짱다리 보행	1
アルカトラス	알카트라스	1
徹底ぶり	철저한 꼴	1
間尺	계산	1	//間尺に合わない。
鉄拳制裁	철권제재	1
各部位	각 부위	1
絶不調ぶり	컨디션 난조인 꼴	1
愚劣ぶり	어리석은 꼴	1
世まい言	넋두리	1
世迷い言	넋두리	1
世迷言	넋두리	1
絶不調	컨디션 난조	1
薄暗がり	어두침침함	1
爪の垢	손톱의 때	1
気分直し	기분 전환	1
目のやり場	눈 둘 곳	1
あら探し	흠집 찾기	1
身の入り	알맹이 상태[身の入り]	1
身入り	알맹이 상태[身の入り]	1
九尾	구미[九尾]	1
余裕綽々	여유만만	1
家族らしいこと	가족다운 일	1
家族らしい事	가족다운 일	1
決まり事	규칙	1
商人風情	상인 따위	1	//商人風情を連れてくるべきじゃなかった。
禁じ手	금기	1
人の風上	사람의 축	1	//人の風上にも置けない奴だな。
駄駄漏れ	줄줄 새어나감	1	//邪悪な気を駄々漏れにする魔物。
カルカソンヌ	카르카손	1
採寸表	치수표	1
クレイドル	클레이들	1
正真正銘	정진정명[正眞正銘]	1
御庭番衆	오니와반슈	1
チャレンジャブル	챌린저블	1
お庭番衆	오니와반슈	1
ヤンキーゴーホーム	양키고홈	1
四無量心	사무량심[四無量心]	1
唐竹割り	당죽 가르기	1
双手刈り	다리잡아 메치기	1
ぬかよろこび	헛된 기쁨	1
外付けハード	외장하드	1
チェンジング	체인징	1
早回し	빨리 감기	1
ジャマー	재머	1
ヘッドバッド	헤드벗	1
最深層	최심층	1
面白半分	재미 반	1	//
八割	8할	1
フレグランス	프레이그런스	1
お世話係	시중계	1
預りもの	보관품	1	//♞預かりもの
預かり物	보관품	1
インサイダー取引	내부자 거래	1
イマジネイション	이매지네이션	1
トゥルー	트루	1
プレリュード	프렐류드	1
デミグラスソース	데미글라스 소스	1
チョークスラム	쵸크슬램	1
ですます調	데스마스조[ですます調]	1
若かりし頃	젊었을 무렵	1
丸めた背	웅크린 등	1
丸めた背中	웅크린 등	1
エムブレム	엠블럼	1
ニーベルンゲン	니벨룽겐	1
手巻きタバコ	봉초담배	1
色見本	색 견본	1	//親父が昔使ってた色見本チャートだよ。
三教科	3교과	1
カラフル	컬러풀	1
体操座り	쭈그려 앉기	1
体育座り	쭈그려 앉기	1
タナボタ	굴러들어오는 복	1
津津浦々	방방곡곡	1	//♞津々浦々
明滅	명멸[明滅]	1
叫喚	규환	1
オレオレ詐欺	보이스피싱	1
亀の甲羅	거북이 등껍질	1
曰くつき	나쁜 사정이 얽힘	1
あぶらあげ	유부	1
油揚げ	유부	1
やたらめったら	엉망진창	1	//俺はやたらめったらに槍を振り回す！
お兄ちゃんごっこ	오빠놀이	1
お医者さんごっこ	의사놀이	1
渾身の出来	혼신의 성과	1
ブルースクリーン	블루 스크린	1
責め甲斐	괴롭히는 보람	1
着飾り甲斐	치장한 보람	1
鍛え甲斐	단련하는 보람	1
からかい甲斐	놀리는 보람	1
開発し甲斐	개발하는 보람	1
両の手のひら	양 손바닥	1
姫花弁	희화판[姬花弁]	1
睨み	눈초리	1	//睨む 가 동사일 경우는 필터링에서 にらみ로 바뀌었음.
塵一つ	티끌 하나	1
筒ぬけ	누설	1	//きっと全てリアンに筒ぬけなんだ。
真実み	진실성	1
御神体	신체	1
人智	인지	1
ボルダリング	볼더링	1
糞溜め	똥구덩이	1
まとめ買い	대량구매	1
寝技	굳히기	1
野宿	야숙	1	//我ながら野宿しなれている。
モールス	모스	1
コンバス	컨버스	1
ナンクセ	트집	1
花鳥風月	화조풍월	1
フローラル	플로럴	1
インセクト	인섹트	1
民百姓	민백성	1
腕マクラ	팔베게	1
息使い	숨결	1
深追い	지나친 추적	1
銀はがし	은박 벗기기	1	//ねぇハンバーガー屋でもらった銀はがしやる？
棒振り剣術	엉터리 검술	1
腕ぐみ	팔짱	1
茶葉	찻잎	1
コマンド	커맨드	1
プレイングマニュアル	플레잉 매뉴얼	1
オマージュ	오마주	1
トワイライト	트와일라이트	1
​ブルーム	블룸	1
​レスキュー	레스큐	1
フットワーク	풋 워크	1
三種の神器	삼종의 신기	1
月会費	월회비	1
願い下げ	사절	1	//こちらこそ願い下げです
早解き	빨리 풀기	1
瞬殺	순살[瞬殺]	1	//瞬殺された
アルタイル	알타이르	1
巻き毛	곱슬머리	1
ディフェンディング	디팬딩	1
タクティカル	택티컬	1
アンハッピー	언해피	1
あさっての方向	엉뚱한 방향	1
中華鍋	중화냄비	1
ゲシュタルト	게슈탈트	1
術法	술법	1
撒菱	마키비시[撒菱]	1	//닌자가 도망칠 때 땅바닥에 뿌리는 도구.
マニピュレータ	매니퓰레이터	1
ハウリング	하울링	1
ヴァイオレット	바이올렛	1
スパロウ	스패로우	1
ジェノサイド	제노사이드	1
ボトルシップ	보틀쉽	1
トーテムポール	토템폴	1
ローリングソバット	롤링 소배트	1
ギムナジウム	김나지움	1
アンコモン	언커먼	1
文金高島田	분킨타카시마다[文金高島田]	1
開発工事	개발공사	1
トンファー	톤파	1
邪気眼	사기안[邪氣眼]	1
ディザスター	디재스터	1
リビルディング	리빌딩	1
超強力	초강력	1
梳き櫛	참빗	1
水汲み	물긷기	1
目障り	눈엣가시	1
桂剥き	돌려깎기	1
ウインナ	비엔나	1
ウインナー	비엔나	1
ウィンナ	비엔나	1
ウィンナー	비엔나	1
付け焼刃	벼락치기	1
のぞき見	엿보기	1
覗き見	엿보기	1
おみまい	병문안	1	//あとでスペシャルなのをおみまいするからね！
湯上がり	목욕 마침	1
湯上がり姿	목욕한 모습	1
令状	영장	1
万が一の時	만일의 경우	1
万が一のとき	만일의 경우	1
栄華の時	영광의 때	1
栄華の時間	영광의 시간	1
栄華の時代	영광의 시대	1	//栄華の時は訪れまいぞ！
不似合い	어울리지 않음	1
不似合	어울리지 않음	1
なりふり	외양	1	//なりふりかまわなくて品がないこと！
ほったらかし	내팽개침	1
放ったらかし	내팽개침	1
昼餉	점심	1	//ううう…折角の昼餉が…
顔型	얼굴형	1
後じさり	뒷걸음질	1
におい袋	향주머니	1
キャリーカート	캐리카트	1
がむしゃら	다짜고짜	1	//自滅覚悟のがむしゃらの一撃。
浮き輪	튜브	1
髪留め	머리핀	1
流し台	설거지대	1
二つ名	이명[二つ名]	1
笑いのツボ	웃음 포인트	1
家内安全	가내안전	1
霧吹き	분무기	1
バトントワリング	배턴 트윌링	1
キャラコスプレ	캐릭터 코스프레	1
裏指導	뒷지도	1
ジャスティスブレイド	저스티스 블레이드	1
記憶ショーガイ	기억장애	1
ひとつご忠告	하나 충고	1
一つご忠告	하나 충고	1
捜しもの	찾는 것	1
ラヴコール	러브콜	1
早見盤	별자리판	1
ヴァリアント	발리안트	1
蚤取り	벼륙잡기	1
下拵え	사전준비	1
ずる休み	땡땡이	1
ズル休み	땡땡이	1
通り雨	지나가는 비	1
かごめかごめ	카고메카고메	1	//일본 애들이 하는 놀이할 때 하는 말이라 함.
焼き討ち	화공	1
ちょこちょこばしり	종종걸음으로 뛰기	1
マナザシ	시선	1
尻すぼみ	용두사미	1	//20世紀少年 尻すぼみ。
尻窄み	용두사미	1	//20世紀少年 尻すぼみ。
四足歩行	4족 보행	1
喉ごし	목넘김	1
遣り取り	주고 받기	1
シャンプーハット	샴푸 모자	1
カサブタ	딱지	1	//상처에 생기는 것
刈込み	가지치기	1
一挙手一挙動	일거수일투족	1
分度器	각도기	1
オシャカ	불량품	1
悪魔憑き	악마빙의	1
地稽古	상호연습	1	//검도 용어
餅つき	떡치기	1
逢い引き	밀회	1
夜回り	야간 순찰	1
インフルエンザ	인플루엔자	1
リンパ球	림프구	1
食器洗い	설거지	1
使いっ走り	잔심부름	1
お召し替え	갈아입음	1	//동사 召し替える 는 거의 안 쓰이는 듯.
抗うつ	항우울	1
エロ本知識	에로책 지식	1
置き傘	예비 우산	1
困惑顔	곤혹스런 얼굴	1
どんちゃん騒ぎ	야단법석	1	//명사라함.
さしすせそ	사시스세소	1
あいうえお	아이우에오	1
現生徒会	현 학생회	1	//現生徒会役員。
ヤケクソ	자포자기	1
自棄糞	자포자기	1
蛇口	수도꼭지	1
羞じらい	수줍음	1
来校	내교	1
腹立ち紛れ	홧김	1	//腹立ち紛れに目の前のフェンスを蹴飛ばした。
腹立ちまぎれ	홧김	1
厄介払い	귀찮은 것 털어버림	1
立て付け	열리고 닫힘	1
言葉面	말의 표면적 의미	1
立てつけ	열리고 닫힘	1
お届け済み	신고필	1
拡張子	확장자	1
水だまり	웅덩이	1
百万石	백만석	1	//三百万石
鍔下	차양 아래	1	//帽子の鍔下から覗く鋭い視線。
双刃	쌍날	1	//双刃の槍
光刃	광인[光刃]	1
一筋の光刃	한 줄기의 광인[光刃]	1
のろけ話	애인 자랑하는 이야기	1
逆ナン	역헌팅[逆ナン]	1
一踏ん張り	조금만 더 분발함	1
ひと踏ん張り	조금만 더 분발함	1
ビヤ樽	맥주통	1
専らの噂	한결같은 소문	1
わしづかみ	움켜잡음	1
年寄扱い	노인 취급	1
共栄	공영	1
いけいけモード	가버리자 모드	1
行け行けモード	가버리자 모드	1
イケイケモード	가버리자 모드	1
ひと抱え	한 아름	1
魔境	마경	1
それどころ	그럴 곳	1	//今はもうそれどころじゃない。それどころの問題ではなかった。お礼もいわない.それどころか悪口をいう始末だ
騎航	기항	1
後背部	배후부	1
咳一つ	기침 하나	1
派手柄	화려한 무늬	1
平伏	평복[平伏]	1
ひれ伏	평복[ひれ伏]	1
面目躍如	면목약여[面目躍如]	1
万に一個	만에 하나	1	//♞万に一つ
万に一つ	만에 하나	1	//
雪隠詰め	막다른 길에 몰아넣음	1
石積み	돌쌓기	1
一閃万里	일섬만리	1
鬼面	귀면[鬼面]	1
刀牙	도아[刀牙]	1
血糊	피	1
膝立ち	무릎서기	1
誰何	수하[誰何]	1
逆座	역좌[逆座]	1
夕空	저녁 하늘	1
対極の側	대극의 측	1
神宝	신성한 보물	1
足回り	발 언저리	1
一手馳走	한 수 대접	1
点前	점전[点前]	1
読み合い	수싸움	1
遅れ馳せ	뒤늦음	1
尋常一様	범상함	1
針山	바늘꽂이	1
冗句	쓸데없는 구절	1
政道批判	정도비판	1
刃味	칼 맛	1
腰ぎんちゃく	허리주머니	1
腰巾着	허리주머니	1
炊き加減	익힌 정도	1
掌底	장저[掌底]	1
空拭き	마른 걸레질	1
帰投	귀환	1
峰打ち	칼등치기	1
前転	앞구르기	1
後転	뒷구르기	1
手妻	요술	1
めった打ち	난타	1
立木打ち	나무치기	1
勝手絶頂	제멋대로 절정	1	//なんでこの野郎は勝手絶頂にしてられる
石塊	돌덩어리	1
腕立て伏せ	팔굽혀펴기	1
うでたてふせ	팔굽혀펴기	1
きりたんぽ	떡꼬치구이	1
魂送り	혼령 달래기	1
当然至極	당연지사	1
拝察	배찰[拜察]	1
徒労感	헛수고감	1
俄か雨	소나기	1
御酌量	참작	1
射線	사선	1
謂われ	설명[謂われ]	1	//そのような謂われをなさるとは。
謂われなき	어이없는	0	//在朝日本人への謂われなき斷罪。
無駄撃ち	헛된 공격	0
注意不足	주의 부족	1
落丁	낙정[落丁]	1
眷属	권속	1
思念	사념	1
背表紙	배표지[背表紙]	1
ひとくくり	일괄	1
ポルターガイスト	폴터 가이스트	1
マルチリンガル	멀티 링귀얼	1
キャトル	캐틀	1
ミューティレーション	뮤틸레이션	1
カニバリズム	카니발리즘	1
コミカライズ	코미컬라이즈	1
デストロイ	디스트로이	1
フルスウィング	풀 스윙	1
ヒョウ柄	표범 무늬	1
まぐわい	성교[まぐわい]	1
角付き	뿔 달림	1
一二三	123	1	//오류 수정임.
シールド	실드	1
帯紐	허리끈	1	//기모노 허리에 감는 끈 같은 것
レベル	레벨	1
名演技	명연기	1
俊足	준족	1
下ごころ	속셈	1
神隠し	카미카쿠시[神隱し]	1
リターンマッチ	리턴 매치	1
テイスト	테이스트	1
ペン立て	연필꽂이	1
都落ち	낙향	1
一問	일문	1
三大風物	3대 풍물	1
スタリオン	스탈리온	1
アッカンベー	메롱	1
パイずり	파이즈리	1
すじがねいり	굳건한 신념	1	//筋金入り
言葉のアヤ	교묘한 표현	1
匙加減	손 짐작	1
間抜け面	얼간이 얼굴	1
マヌケ面	얼간이 얼굴	1
幾すじ	몇 가닥	1
幾筋	몇 가닥	1
カラ元気	허세	1
やっかいごと	귀찮은 일	1
組んずほぐれつ	엎치락 뒤치락	1
気乗り薄	내키지 않음	1
気のり薄	내키지 않음	1
ひこーき	비행기	1	VTp	// :교통수단
バースデー	버스데이	1
シタゴコロ	속셈	1
くりすます	크리스마스	1
押し競饅頭	밀어내기 놀이	1
押しくら饅頭	밀어내기 놀이	1
両手に花	양 손에 꽃	1
あぐれっしぶ	어그레시브	1
さぷらいず	써프라이즈	1
トップシークレット	탑 시크릿	1
ゆうじゅうふだん	우유부단	1
紙相撲	종이인형 씨름	1
差し手	샅바잡기 수법	1
夜這い星	별똥별	1
よばい星	별똥별	1
真一文字	일직선	1
代わり番こ	교대 순번	1
かわりばんこ	교대 순번	1
お腹ペコ	배고픔	1
腹ペコ	배고픔	1
お腹ペコペコ	배 꼬록꼬륵	1
腹ペコペコ	배 꼬록꼬륵	1
お腹ぺこぺこ	배 꼬록꼬륵	1
腹ぺこぺこ	배 꼬록꼬륵	1
お腹ぺっこぺこ	배 꼬록꼬륵	1
腹ぺっこぺこ	배 꼬록꼬륵	1
ひと押し	한번 밀기	1	//私は最後のひと押しをする為。
ひと噛み	한번 깨물기	1
ひと撫で	한번 쓰다듬기	1	//頬をひと撫でした。
ひと舐め	한번 빨기	1	//ひと舐めしたいです。
ひと息	한숨	1
ひと周り	한 바퀴	1
ひと周り年上	12살 연상	1
ひと周り年下	12살 연하	1
ひとっ風呂	한 목욕	1	//
ひと風呂	한 목욕	1	//
ひとやすみ	한 휴식	1
ひと休み	한 휴식	1
ひと皮	한 가죽	1
ひと泡	한 거품	1	//今から魔王軍に、ひと泡吹かせてやるぜ。
ひと夏	한 여름	1
ひと手間	한 수고	1
針のムシロ	바늘 방석	1
出来てしまった婚	속도위반 결혼	1	//♞出来ちゃった婚
出来てしまった結婚	속도위반 결혼	1	//♞出来ちゃった婚
出来婚	속도위반 결혼	1
出来結婚	속도위반 결혼	1
できてしまった婚	속도위반 결혼	1	//♞
できてしまった結婚	속도위반 결혼	1	//♞できちゃった結婚
ぷらいべーと	프라이빗	1
表情筋	얼굴 근육	1
ベビードール	베이비돌	1
身づくろい	몸치장	1
顔面筋	얼굴 근육	1
これくしょん	콜렉션	1
うえるかむ	웰컴	1
片りん	편린	1
ひと安心	한 안심	1
たん瘤	혹	1
見え見え	뻔히 보임	1
ジゴウジトク	자업자득	1
さぶいぼ	소름	1
よそゆき	외출	1
よそゆき顔	점잖은 얼굴	1
よそゆきの顔	점잖은 얼굴	1
よそ行きの顔	점잖은 얼굴	1
よそ行き顔	점잖은 얼굴	1
決まりごと	정해진 일	1
ダダ漏れ	줄줄 샘	1
聞えよがし	들리게 욕하기	1
聞こえよがし	들리게 욕하기	1
葉擦れ	나뭇잎 스침	1
つきっきり	쭉 붙어있음	1
付きっきり	쭉 붙어있음	1
オニごっこ	술래잡기	1
こぶし大	주먹크기	1
三大流派	3대 유파	1
遠乗り	멀리 타고 감	1	//たまににこやかな顔で遠乗りに出かけていく。
シグ	시그	1	//발음
おやすみのキス	잘자요 키스	1
お休みのキス	잘자요 키스	1
おやすみキス	잘자요 키스	1
お休みキス	잘자요 키스	1
跡目争い	상속 분쟁	1
チャージショット	챠지 샷	1
ターニングポイント	터닝 포인트	1
ぶつ切り	토막내서 자름	1
プリティキュート	프리티 큐트	1	//キュート 땜에 오류 일으킴 : プリティキュートなお花の精霊
//朝霧	아침 안개	1
月代	에도시대 머리 스타일	1
独り歩き	홀로 걷기	1
捨て駒	버리는 말	1
おえかき	그림 그리기	1
横なぎ	횡치기	1
横薙ぎ	횡치기	1
依存関係	의존관계	1
深読み	억측	1
ちょび髭	콧수염	1
隣り合わせ	서로 이웃	1
眉一つ	눈썹 하나	1
鎧袖一触	개수일촉[鎧袖一觸]	1
しゃれっ気	멋져보이고픈 끼	1
洒落っ気	멋져보이고픈 끼	1
にやけ笑い	간들거리는 웃음	1
向き不向き	적합함과 부적합함	1
業突く張り	탐욕스러움	1
強突く張り	탐욕스러움	1
乗り物酔い	멀미	1
乗物酔い	멀미	1
下天	하천	1
雄大さ	웅대함	1	//할 수 없이...
流れ的	흐름적	1
姿かたち	모습	1
脇汗	겨땀	1
手汗	손땀	1
鼻づまり	코막힘	1
肉球	육구[肉球]	1
二人称梦名	2인칭	1
無防備さ	무방비함	1
日和見主義	관망주의	1
辣腕	빼어난 솜씨	1
じゅーぶん	충분	1
ぜってー	절대	1
所以	까닭	1
追っかけっこ	술래잡기	1
黙考	묵고[默考]	1
おかんむり	저기압	1
毛づくろい	털고르기	1
或る程度	어느 정도	1
デブリ	데브리	1
生理痛	생리통	1
鼻頭	콧등	1
非の打所	트집 잡을 곳	1
非のうちどころ	트집 잡을 곳	1
追剥	노상 강도	1
出たとこ勝負	운에 맡기는 승부	1
出た所勝負	운에 맡기는 승부	1
弥助	야스케	1	//초밥의 다른 이름...?
蟹股	안짱다리	1
がに股	안짱다리	1
猿顔	원숭이 얼굴	1
紙箱	종이 상자	1
トリップ	트립	1
歌え踊れ	노래해라 춤춰라	1
歌えや踊れや	노래해라 춤춰라	1
歌えや踊れ	노래해라 춤춰라	1
飲め歌え	부어라 마셔라	1
飲めや歌え	부어라 마셔라	1
飲めや歌えや	부어라 마셔라	1
手持ち無沙汰	할 일 없이 따분함	1
手持無沙汰	할 일 없이 따분함	1
滅殺	멸살	1	//滅殺して。
秒刻み	초단위	1	//その心臓の鼓動は秒刻みで激しくなってゆく。
釣り目	치켜 올라간 눈	1
釣り目がち	치켜 올라간 눈매	1
吊り目	치켜 올라간 눈	1
吊り目がち	치켜 올라간 눈매	1
伏せ目がち	내리뜬 눈매	1
一本筋	한 줄기	1
のど越し	목넘김	1
喉越し	목넘김	1
ひとそろい	한 세트	1
開けっぴろげ	열어젖힘	1	//文明開化期は開けっぴろげでした
あけっぴろげ	열어젖힘	1
経験則	경험 법칙	1
自撮り	셀카	1
おなに	오나니	1
行き当たりばったり	계획성 없음	1
幻肢痛	환지통	1
舌舐り	입맛 다시기	1
舌嘗り	입맛 다시기	1
やり込み	파고들기[やり℡입み]	1
百幸千福	백행청복[百幸千福]	1
無駄飯食い	무위도식함	1
逢魔ヶ刻	봉마의 각[逢魔ヶ刻]	1
集中力	집중력	1	//集中力があがった
おねむ	졸음	1
コンセプチュアル	컨셉츄얼	1
地対地	지대지	1
地対空	지대공	1
上げ膳据え膳	갖다 바친 밥상	1
ちゅーもーく	주-목	1
申開き	해명	1
おせっかい焼き	공연한 참견	1
やぶさか	인색함	1	//生涯の忠誠を誓うこともやぶさかじゃない。
のーこめんと	노코맨트	1
得意不得意	잘하는 것 못하는 것	1
巻き髪	파마 머리	1
はしたぜに	푼돈	1
書き下ろし多め	새로 쓴게 많음	1
根まわし	사전 교섭	1
縫い込み	꿰메어 넣기[縫い℡입み]	1
底光り	그윽한 빛	1
大盛り上がり	대성황	1
への字口	へ 글자 모양 입	1
使い古された手	낡은 수	1
大進撃	대진격	1
天日干し	햇볕에 말리기	1
あきたこまち	아키타코마치	1	//쌀 이름
悪役面	악역 얼굴	1
ばかげた話	바보 같은 이야기	1
米生産	쌀 생산	1
採れ高	채취고	1
ひと眠り	한 잠	1
アィディア	아이디어	1
お見通し	꿰뚫어 보심	1
生まれてこのかた	태어나서 지금까지	1
頭の出来	머리의 지능	1	//頭の出来がみんな同じだと思ってるやついるよな
狸顔	너구리 얼굴	1
まつ毛	속눈썹	1
腹ごたえ	배부른 느낌	1
腹応え	배부른 느낌	1
食べ応え	식감	1
揉み応え	주무르는 반응	1
揉みごたえ	주무르는 반응	1
口ごたえ	말대답	1
張り手	손바닥 치기	1
好き放題	제멋대로	1
すき放題	제멋대로	1
猫柄	고양이 무늬	1
見敵必殺	견적필살	1
史実	사실[史實]	1
上意討ち	명에 따른 토벌[上意討ち]	1
矛先	창 끝[矛先]	1
輩行名	출생순서에 의한 이름[輩行名]	1
切捨御免	모욕 처벌[切捨御免]	1
無礼討ち	모욕 처벌[無禮討ち]	1
無礼打ち	모욕 처벌[無禮打ち]	1
グラマラス	글래머러스	1
ぱいぱい	빠이빠이	1
ツクール	츠쿠르	1
貝がら	조개껍질	1
ガンプラ	건프라	1
ガンプレイ	건플레이	1
ガンポッド	건포드	1
ガンバード	건버드	1
ガンヘッド	건헤드	1
ガンボール	건볼	1
ガンパウダー	건파우더	1
ガントラック	건트럭	1
ガンタンク	건탱크	1
ガンアクション	건 액션	1
ガンカメラ	건카메라	1
ガンコントローラ	건 컨트롤러	1
ガンシューティング	건슈팅	1
ガンスラッシュ	건스래쉬	1
ガンスパイク	건스파이크	1
ガンスミス	건스미스	1
ガンランチャー	건 런쳐	1
サイベース	사이베이스	1
サイテック	사이테크	1
レェン	렌	1
ラァン	란	1
身かわし	회피	1
身かわし術	회피술	1
ちから	힘	1
革片	가죽조각	1
イモレーション	이몰레이션	1
ハウラ	하우라	1
牛角	소뿔	1
売り出し中	매출중	1
安牌	안전빵	1
安全牌	안전빵	1
粘り勝ち	버티기 승리	1

//할 수 없이 상용어구로 등록 ('명)
やっとの事	간신히	0	//やっとの事開放されることとなる
幸せのかたち	행복의 형태	0
持て持て	인기 만점	0	//원랜 연어임
もてもて	인기 만점	0	//원랜 연어임
真っ平ら	평평함	0
ちょっとした事情	약간의 사정	0
ほんの少しずつ	아주 조금씩	0
多分野	다분야	0	//多分野に秀でた才
無用の用	무용지용	0
一向宗	일향종	0
元気な盛り	건강한 한창 때	0
すんでのところ	위기의 순간	0	UMe	//시간 : 할수없이 상용어구 등록...
若しものこと	예기치 못한 일	0
もしものこと	예기치 못한 일	0
きつい目	엄한 눈	0	VBp	//신체부위 : 
一緒くた	뒤섞음	0	//花も雑草も一緒くたに抜く
最後の砦	최후의 보루	0
一生懸命さ	최선을 다함	0
我が物顔	자기 것인양	0
おもらし	오줌 흘리기	0
大の字	대자[大の字]	0	//携帯を閉じてベッドに大の字になる。
いやなよかん	싫은 예감	0	//いやなよかんがするコースは駅までコース。
あの日の出会い	저 날의 만남	0
だめさ加減	모자란 정도	0
かつらむき	돌려깎기	0
かつおぶし	가다랭이포	0
赤いもみじ	붉은 단풍	0
長長話	긴 이야기	0
いか程の時間	얼마나의 시간	0	UMe	//시간 : されてから、いかほどの時間がたったか。
いか程なもの	어느 정도의 것	0	//如何ほどなものか。
幼い時分	어린 시절	0
今一つなもの	조금 부족한 것	0	//射精の快感も今一つなものになってしまった。

//'명사 끝








//█████████████████████████████████████████████████████████████████████████████
// #.형용사, 부사
//█████████████████████████████████████████████████████████████████████████████
//[なのに] '형용사 및 '부사
短めに	짧막하게	0
短めな	짧막한	0
絞りたての	갓 짜낸	0
絞り立ての	갓 낳은	0
うみたての	갓 낳은	0
生みたての	갓 낳은	0
産みたての	갓 낳은	0
産まれ立ての	갓 태어난	0
産まれたての	갓 태어난	0
状態異常に	상태이상에	0	//あらゆる状態異常に少しだけ耐性が付く
大振りの	큼직한	0
昔の様に	옛날처럼	0
昔のように	옛날처럼	0
当たり前の様に	당연한 것처럼	0
薄手の	얄팍한	0
脱ぎたての	금방 벗은	0
疲れ知らず	지칠줄 모르고	0
疲れ知らずの	지칠줄 모르는	0
搾りたての	갓 짜낸	0
消えかけの	사라지기 시작한	0
癒しの	치유의	0
脱ぎかけの	벗기 시작한	0
見かけだけの	허울뿐인	0
見掛けだけの	허울뿐인	0
親し気に	친근하게	0
付き合いたての	사귄지 얼마 안 된	0
キツめの	뻑뻑한	0
きつめの	뻑뻑한	0
深めの	깊은 편의	0
魂吸いの	영혼 흡수의	0	//魂吸いの指輪
随分な	심한	0
ずいぶんな	심한	0
無碍に	막힘없이	0
何某かの	얼마간의	0
入り立ての	갓 들어온	0
ぺしゃんこに	납작하게	0
ぺしゃんこ	납작	0
ペシャンコに	납작하게	0
ペシャンコ	납작	0
真っすぐに	곧바로	0
済し崩しに	조금씩	0
なしくずしに	조금씩	0
済し崩しのまま	애매한 채	1
済し崩しのままに	애매한 채로	0
なし崩しのまま	애매한 채	1
なし崩しのままに	애매한 채로	0
なしくずしのまま	애매한 채	1
なしくずしのままに	애매한 채로	0
腹立ちのまま	화가 난 채	1
腹立ちのままに	화가 난 채로	0
多めな	넉넉한	0
間抜な	얼빠진	0
薄めな	얇은	0
薄めに	얇게	0
侃々諤々の	기탄없는	0
侃々諤々な	기탄없는	0
やばんな	야만스러운	0
余りと言えば余りの	너무했다면 너무한	0
余りと言えば余り	너무했다면 너무함	1
あまりといえばあまりの	너무했다면 너무한	0
あまりといえばあまり	너무했다면 너무함	1
くすぐったげな	낯간지러운 듯한	0
くすぐったげに	낯간지러운 듯이	0
子持ちの	아이 딸린	0
胡散臭げな	수상한듯한	0
胡散臭げに	수상한듯이	0
途端に	순간에	0
次第次第に	차츰차츰	0
頼りなげな	미덥지 않은 듯한	0
頼りなげに	미덥지 않은 듯이	0
ありきたりな	흔히 있는	0
ありきたりの	흔히 있는	0
こん身の	혼신의	0
至急の	시급한	0
大層な	대단한	0
胡乱げな	수상한 듯한	0
胡乱げに	수상한 듯이	0
何がしかの	얼마간의	0
なにがしかの	얼마간의	0
狂おしげな	미칠 듯한	0
狂おしげに	미칠 듯이	0
不満げな	불만스러운 듯한	0
不満げに	불만스러운 듯이	0
気だるげな	나른한 듯한	0
気だるげに	나른한 듯이	0
目深に	깊숙히	0	//帽子を取り出すと目深に被り、
秘かな	은밀한	0
秘かに	은밀하게	0
苛立ち紛れに	초조한 나머지	0
苛立ちまぎれに	초조한 나머지	0
大き目な	다소 큰	0
大き目の	다소 큰	0
俄かに	졸지에	0
開口一番に	입을 열자마자	0
不審げに	의심스러운 듯이	0
不審げな	의심스러운 듯한	0
我先に	앞 다투어	0
不愉快げな	불쾌한 듯한	0
不愉快げに	불쾌한 듯이	0
さり気に	아무렇지 않게	0
まっしぐらな	무대포 돌진인	0
愉快げに	유쾌한 듯이	0
愉快げな	유쾌한 듯한	0
上目づかいに	눈을 치켜뜨고	0
気まずげに	거북한 듯이	0
気まずげな	거북한 듯한	0
儚げに	덧없이	0
儚げな	덧없는	0
お気の毒そうな	딱한 듯한	0
お気の毒そうに	딱한 듯이	0
超元気そうな	초건강한 것 같은	0
おっかしーな	이상한	0
なんとなしに	왠지 모르게	0
しょーじきに	정직하게	0
驀地に	전력으로	0
気のり薄な	내키지 않는	0
気乗り薄な	내키지 않는	0
//結構な	상당한	0
場違いな	장소에 맞지 않는	0
場違いの	장소에 맞지 않는	0
場違いに	장소에 맞지 않게	0
ひと思いに	단숨에	0
飛びっきり	월등히	0
飛びっきりな	월등한	0
飛びっきりに	월등히	0
飛びきり	월등히	0
飛びきりに	월등하게	0
飛びきりな	월등한	0
飛び切りに	월등하게	0
飛び切りな	월등한	0
前のめりに	기우뚱하게	0
血気盛んに	혈기왕성하게	0
血気盛んな	혈기왕성한	0
朧げな	희미한	0
朧げに	희미하게	0
へんぴな	외진	0
せっかちな	성급한	0
せっかちに	성급하게	0
せっかちの	성급한	0
超常の	초현실의	0
向こう見ずの	무모한	0
向こう見ずな	무모한	0
向こう見ずに	무모하게	0
久方の	오랜	0
余計に	더욱 더	0
あのていどの	저 정도의	0	//このていどの展開
あのように	그처럼	0
あの様に	그처럼	0
あべこべな	뒤바뀐	0
あべこべに	뒤바뀌게	0
あべこべの	뒤바뀐	0
いい加減な	적당한	0
いくばくかの	약간의	0
いつのまに	어느새	1
おしずかに	조용히	0
おしずかな	조용한	0
おためごかしの	남을 위해주는 체하는	0
からかいの	놀림의	0
カラッカラに	바짝바짝하게	0
からっからに	바짝바짝하게	0
がらんどうな	텅 빈	0
がらんどうの	텅 빈	0
きゅうに	갑자기	0
ケタ違いの	격이 다른	0
けったいな	희안한	0
こてんこてんに	철저히	0
こてんばんに	철저히	0
このていどの	이 정도의	0	//このていどの展開
さみしげに	쓸쓸한 듯이	0
さみしげな	쓸쓸한 듯한	0
さりげに	태연하게	0	//さりげに嘘ついちゃだめよってばよ
じきじきに	직접	0
セレブな	귀티나는	0
そうそうに	서둘러	0
そぞろに	어쩐지	0
そのていどの	그 정도의	0	//このていどの展開
そのように	그처럼	0
その度に	그때마다	0
//その様に	그처럼	0
ただ単に	단지 그저	0
チャキチャキの	진정한	0
ちゃきちゃきの	진정한	0
ドサクサに	혼잡하게	0
どさくさに	혼잡하게	0
なにげに	무심코	0
なんとはなしに	왠지 모르게	0
なんとは無しに	왠지 모르게	0
ひたすらに	오로지	0
ほんのわずな	그저 얼마 안 되는	0
ムフフな	므흣한	0
モノホンの	진품의	0	//甘えんぼでお兄ちゃんっ子だったはずのモノホンのアイツが
わずかな	얼마 안 되는	0
間髪入れずに	지체없이	0
甘めな	달달한	0
甘めに	달달하게	0
甘めの	달달한	0	//甘めの顔立ち
高級そうな	고급인듯한	0
瓜二つの	쏙 빼닮은	0	//瓜二つの顔の二人
校内一の	교내 제일의	0
弓なりに	활처럼	0
僅かに	조금	0
気遣わし気に	신경쓰이는 기분으로	0
気付かれずに	눈치채지 못하게	0
女だてらに	여자답지 않게	0
濃いめな	진한	0
濃いめに	진하게	0
濃いめの	진한	0
抑えめな	억제하는 편인	0
抑えめに	억제하는 편으로	0
抑えめの	억제하는 편인	0
強めに	조금 강하게	0
当然とばかりの	당연하다는 듯이	0
代わる代わるに	번갈아가며	0
徒らに	부질없이	0
麗しの	아름다운	0	//麗しのマドンナ。
露わに	공공연하게	0
晩くに	늦게	0
満ち満ちに	가득가득히	0
満悦そうな	만족스러운 듯한	0
無下の	하찮은	0
美しの	아름다운	0
悶々の	번민의	0
悶悶の	번민의	0
剥きだしの	노출된	0
粉々に	산산히	0
粉粉に	산산히	0
使い古しの	낡은	0
//手つかずの	손대지 않은	0
矢継ぎ早に	잇달아	0
十二分に	충분히	0
我勝ちに	앞다투어	0
愛しの	사랑스러운	0
言い出しっぺの	먼저 말을 시작한 사람인	0
円を描くような	원을 그리는 듯한	0	//円を描くようにして彼女の口腔を支配する。
円を描くように	원을 그리듯이	0	//円を描くようにして彼女の口腔を支配する。
然りげに	태연하게	0
遠回しな	완곡한	0
遠回しに	완곡하게	0
肉厚の	두툼한	0
飲みかけの	마시다 만	0
飲み掛けの	마시다 만	0
程程に	적당히	0
早々に	조속히	0
直々に	직접	0
真っ先に	가장 먼저	0
千々に	이것저것에	0
初めての時のような	처음과 같은	0
初めての時のように	처음과 같이	0
恥ずかしの	부끄러운	0
何とはなしに	왠지 모르게	0
何とは無しに	왠지 모르게	0
何気に	무심코	0
学園一の	학원 제일의	0
学校一の	학교 제일의	0	//その手紙を学校一の人気者
丸わかりに	뻔히 보이게	0
丸わかりの	뻔히 보이는	0
嬉し恥ずかしの	기쁘고 부끄러운	0
希代な	희안한	0
雨ふりの	비오는	0	//雨ふりの歌
ゆゆしき	중대한	0	//ゆゆしき問題
//死にたがりの	죽고 싶어하는	0	//どうも、死にたがりの狂人ね
アヤシゲな	수상한	0
なげやりな	자포자기인	0	//なげやりな苦笑を浮かべている
出来たての	갓 만들어진	0	//出来たての料理を並べる
洗いたての	금방 씻은	0
//いいように	좋을대로	0	//いいように操られましょう。俺がいついなくなってもいいように。
いたずらげに	장난스럽게	0
サイン入りの	사인이 들어있는	0
意味深に	의미심장하게	0
意味深な	의미심장한	0
まことしやかに	그럴듯하게	0
まことしやかな	그럴듯한	0
嬉しい恥ずかしな	기쁘고 부끄러운	0	//♞嬉し恥ずかしな昼食時間は、平和に過ぎていった。
切なげな	안타까운	0
切なげに	안타깝게	0
せつなげな	안타까운	0
せつなげに	안타깝게	0
得意げな	우쭐해하는	0
しぜーんに	자연스럽게	0
円らな	동그란	0	//円らな瞳
小意気な	멋진	0
常識外れな	상식에서 벗어난	0	//これまで体験したことのない常識外れな大騒動に胸を躍らせていく
ごくごくの	극도의	0	//ごくごくのひみつ
苛立たしげな	초조한 듯한	0
苛立たしげに	초조한 듯이	0
へいわな	평화로운	0	//
おりこうな	영리한	0	//おりこうなモーショントラッキング・カメラ
じゃれ合いの	서로 장난치는	0	//じゃれ合いの最中に触れた手足の感触に劣情を一切覚えなかったと言えば嘘になる。
朴訥な	소박한	0	//朴訥な人だよな
コッテンパンに	무참하게	0	//今日こてんぱんに負けちゃったのは、
こってんぱんに	무참하게	0	//今日こてんぱんに負けちゃったのは、
コテンパンに	무참하게	0	//今日こてんぱんに負けちゃったのは、
こてんぱんに	무참하게	0	//今日こてんぱんに負けちゃったのは、
コテンパに	무참하게	0	//今日こてんぱんに負けちゃったのは、
こてんぱに	무참하게	0	//今日こてんぱんに負けちゃったのは、
こてんぱん	무참함	1
コテンパン	무참함	1
ホドホドに	적당히	0
ふきげんな	언짢은	0
らんぼうな	난폭한	0	//らんぼうな方法でなきゃ起きないのかと思った
しょうじきな	정직한	0
しょうじきに	정직하게	0
とくべつな	특별한	0
とくべつに	특별히	0
興味深げな	흥미 깊은듯한	0
興味深げに	흥미 깊은듯이	0
まんまるの	둥그런	0	//まんまるの月が光ってて
中々に	꽤	0
中中に	꽤	0
なかなかに	꽤	0
内内に	은근히	0
内々に	은근히	0
すべらかな	미끌미끌한	0
//結構な	상당한	0
不満そうな	불만인듯한	0
ありていな	있는 그대로인	0
有体な	있는 그대로인	0
同然の	마찬가지의	0
こしゃくな	시건방진	0
重たげな	무거운 듯한	0
頻繁な	빈번한	0
頻繁に	빈번하게	0
ちいちゃな	작은	0	//こんなちいちゃな体なのに
御機嫌伺いの	안부를 묻는	0
ご機嫌伺いの	안부를 묻는	0
臆さずに	겁내지 않고 	0	//公衆の面前でも臆さずに
横跳びに	황급히	0
横っ跳びに	황급히	0
横飛びに	황급히	0
横っ飛びに	황급히	0
横とびに	황급히	0
横っとびに	황급히	0
遠慮がちの	조심스러운	0
遠慮がちな	조심스러운	0
遠慮がちに	조심스럽게	0
木っ端みじんに	산산조각으로	0
こなみじんに	산산조각으로	0
某かの	얼마간의	0
愚かの	어리석은	0
意味ありげな	의미 있는듯한	0
意味ありげに	의미 있는듯이	0
長きに	긴 세월에	0

//◆トタリ형 '형용사
//▀▀▀▀▀▀▀▀▀▀▀▀▀▀▀▀▀▀▀▀▀▀▀▀▀▀▀▀▀▀▀▀▀▀▀▀▀▀▀▀▀▀▀▀▀▀▀▀▀▀▀▀▀▀▀▀▀▀▀▀▀▀▀▀▀▀▀▀▀▀▀▀▀▀▀▀▀
勝手知ったる	모두 꿰뚫고 있는	0
かくしゃくたる	건장한	0
かくしゃくと	건장하게	0
がく然	아연실색	1	//愕然
モンモンと	번민스럽게	0
もんもんと	번민스럽게	0
らんらんと	반짝반짝	0
高らかたる	드높은	0
高らかと	드높이	0
恐々と	두려워하며	0
気息奄々たる	숨을 할딱거리는	0
気息奄奄たる	숨을 할딱거리는	0
気息奄々と	숨을 할딱거리며	0
気息奄奄と	숨을 할딱거리며	0
訥々と	더듬더듬	0
段々と	점점	0
爛々たる	형형한	0
爛爛たる	형형한	0
爛々と	형형하게	0
爛爛と	형형하게	0
朗々と	낭랑하게	0
冷然と	냉정히	0
隆々たる	융성한	0
隆々と	융성하게	0
茫然たる	망연한	0
茫然と	망연히	0
呆然たる	어안이 벙벙한	0
呆然と	멍하니	0	//어안이 벙벙히
名立たる	유명한	1
悶々たる	번민하는	0
悶悶たる	번민하는	0
悶々と	번민스럽게	0
悶悶と	번민스럽게	0
馥郁たる	그윽한	0
馥郁と	그윽히	0
散々たる	산산조각난	0	//その結果、散々たる敗北を与えられ
潸々と	주륵주륵	0
潸潸と	주륵주륵	0
颯爽たる	씩씩한	0
颯爽と	씩씩하게	0
生生たる	생생한	0
騒然と	어수선하게	0
奄々たる	할딱거리는	0
奄奄たる	할딱거리는	0
奄々と	할딱거리며	0
奄奄と	할딱거리며	0
易々と	거뜬히	0
易易と	거뜬히	0
艶々と	반들반들	0
傲然と	오만하게	0
鬱々と	우울하게	0
鬱鬱と	우울하게	0
鬱蒼と	울창하게	0
悠然たる	유연한	0
悠然と	유연히	0
長長と	장황히	0
燦々たる	찬란한	0
燦燦たる	찬란한	0
燦々と	찬란히	0
惨憺たる	처참한	0
青々と	푸릇푸릇	0
青青と	푸릇푸릇	0
楚々たる	청초한	0
楚楚たる	청초한	0
楚々と	청초하게	0
楚楚と	청초하게	0
楚々とした	청초한	0
楚楚とした	청초한	0
炯々と	형형하게	0
和気藹々たる	화기애애한	0
和気藹々と	화기애애하게	0
矍鑠たる	건장한	0
矍鑠と	건장하게	0
黒々たる	시커먼	0
黒々と	시커멓게	0
喜々と	희희낙락	0	//(きき) : 喜々として犯される淫夢だった。喜々として泳ぎ回る影。
喜喜と	희희낙락	0	//(きき) : 喜々として犯される淫夢だった。喜々として泳ぎ回る影。
嬉々と	희희낙락	0	//(きき) : 喜々として犯される淫夢だった。喜々として泳ぎ回る影。
嬉嬉と	희희낙락	0	//(きき) : 喜々として犯される淫夢だった。喜々として泳ぎ回る影。
飄々と	홀연히	0
飄々たる	홀연한	0
嫣然と	싱긋	0
延々	계속	0	//延々3時間にわたった淀川さんへのインタビュー。ずっと延々あたしがデレなかったおかげで
滔々と	거침없이	0
滔々たる	거침없는	0
煌々と	형형히	0
煌々たる	형형한	0
和気藹々	화기애애	0
和気藹々と	화기애애하게	0
和気藹々たる	화기애애한	0
玲瓏と	영롱하게	0
玲瓏たる	영롱한	0
蕭々と	스산하게	0
蕭々たる	스산한	0
暗々と	어둡게	0
暗々たる	어두운	0
陰々と	음산하게	0
陰々たる	음산한	0
陰陰と	음산하게	0
陰陰たる	음산한	0
諾諾と	고분고분하게	0
諾諾たる	고분고분한	0
諾々と	고분고분하게	0
諾々たる	고분고분한	0
忸怩と	창피스럽게	0
忸怩たる	창피스러운	0
緩々と	유유히	0
緩々たる	유유한	0
陶然と	도연[陶然]히	0
陶然たる	도연[陶然]한	0
遅々と	느리게	0
遅々たる	느린	0
飢えたる	굶주린	0
陰々滅々と	어두침침	0
陰々滅々たる	어두침침한	0
陰陰滅滅と	어두침침	0
陰陰滅滅たる	어두침침한	0
平平凡凡と	평평범범	0
平平凡凡たる	평평범범한	0
平々凡々と	평평범범	0
平々凡々たる	평평범범한	0
茫茫と	망망	0
茫々と	망망	0
茫茫たる	망망한	0
茫々たる	망망한	0
虎視眈々と	호시탐탐	0
蕭蕭たる	스산한	0
蕭蕭と	스산하게	0
濛濛と	자욱하게	0
濛々たる	자욱한	0
濛々と	자욱하게	0
朴訥と	소박하게	0
朴訥たる	소박한	0
轟々と	요란하게	0	//轟々と吹き荒れる吹雪の中
侃々諤々と	기탄없이	0
白々と	하얗게	0
秘めたる	감춰진	0


//그외 '형용사 및 '부사 및 접속사
//▀▀▀▀▀▀▀▀▀▀▀▀▀▀▀▀▀▀▀▀▀▀▀▀▀▀▀▀▀▀▀▀▀▀▀▀▀▀▀▀▀▀▀▀▀▀▀▀▀▀▀▀▀▀▀▀▀▀▀▀▀▀▀▀▀▀▀▀▀▀▀▀▀▀▀▀▀
言われなき	이유 없는	0
何時しか	어느덧	0
立ち代り入れ替わり	쉴새없이 잇달아	0
入れ替わり立ち代り	쉴새없이 잇달아	0
相まって	더불어	0
相俟って	더불어	0
大よそ	대략	0
うるわしき	아름다운	0
碌すっぽ	변변히	0
陸すっぽ	변변히	0
ろくすっぽ	변변히	0
特に大して	딱히 별로	0
特にたいして	딱히 별로	0
とくにたいして	딱히 별로	0
割かし	비교적	0
偽りなき	거짓 없는	0
只只	그저	0
唯唯	그저	0	//唯唯謝る
ただただ	그저	0	//ただただ目を見張るばかりだった
杳として	묘연히	0
専らの	한결 같은	0
今なお	여전히	0
今尚	여전히	0
直ぐさま	곧 바로	0
ゆめゆめ	절대로	0
努努	절대로	0
激似の	꼭 닮은	0
キツ目の	빡빡한	0
キツ目	빡빡함	0
もぉっと	좀 더	0
もぉ～っと	좀~더	0
だんぜん	단연	1	//だんぜんきれいだ。
今こそ	지금이야말로	0	//私は、今こそと思った。
漸う	겨우	0
悠久なる	유구한	0
まぁったく	완전히	0
其々	각각	0
完膚無き	철저하게	0
完膚無い	철저하게	0	//♞完膚無き
事もあろうに	하필이면	0	//それが事もあろうにネットゲームの中でばったり出会う
なんとかかんとか	이래저래	0
ちいとばかし	조금만	0
恙無く	무사히	0
恙なく	무사히	0
まずもって	우선	0
疎かったり	서먹하거나	0	//疎かったり 활용이 안 됨
頗る	몹시	0	//부사하고 한다.
ちょこぉっと	조금	0
然らば	그러면	0
しからば	그러면	0
さようしからば	그렇다면	0
然様然らば	그렇다면	0
左様然らば	그렇다면	0
もしかしなくても	틀림없이	0
ちょぴっと	조금	0
びくとも	꿈쩍도	0	//びくびくとも
おもいっきり	마음껏	0
おもいっきし	마음껏	0
ごもっともの	지당한	0
頼もしき	믿음직한	0
もっともの	지당한	0
ふさわしき	적당한	0
なーるほーど	과~연	0
ほっとんど	거의	0
態々	일부러	0
さぁすが	과연	0
すたこらさっさと	후다닥 재빨리	0
すたこらさっさ	후다닥 재빨리	0	//言われなくてもすたこらさっさだぜ 
すたこら	후다닥	0
なっかなか	꽤	0
取り合えず	우선	0
めーいっぱい	힘껏	0
けしからぬ	괘씸한	0	//연어라고 한다.
怪しからぬ	괘씸한	0	//来ないとは怪しからぬ奴だ
ちょぉっと	조금	0
まんざら	그다지	0
取っかえ引っかえ	번갈아	0
嫌も何も	싫든 좋든	0
わんさか	와르르	1
悪名高き	악명 높은	0
すばらしき	훌륭한	0
罪深き	죄 깊은	0
凄まじっく	굉장하게	0
凄まじっくて	굉장해서	0
ちっとばかし	조금만	0
ちっと許し	조금만	0
力無き	무력한	0
謎多き	수수께끼 많은	0	//謎多き女
絆深き	인연이 깊은	0	//絆深き者
うら若き	젊디 젊은	0
蒼き	푸른	0	//蒼き硝煙
曇りなき	흐림 없는	0	//曇りなき眼差しを放つ少年
キツめに	세게	0	//キツめに抱き締めあって姉ちゃんは自分の部屋に戻っていった。
きつめに	세게	0
続け様に	연이어서	0
嬉しからざる	기쁘지 않은	0
望ましからざる	바람직하지 않은	0
イカした	멋졌던	0
イカす	멋진	0
いっ～ぱい	가~득	0
いっーぱい	가-득	0
イマイチ	좀 더	0
いまいち	좀 더	0
うすら	엷은	0
//かくして	이리하여	0	//**持ってるのはかくしておきたい。
かな～り	꽤	0
かなーり	꽤	0
からきし	전혀	0
からっきし	전혀	0
こういうと	이렇게 말하면	0	//こういうと失礼だけ
こういうところ	이러한 곳	0
ここんとこ	요즘	0
ことのほか	의외로	1
さっすが	과연	0
さてこそ	그러고보니	0
じばらく	당분간	0
しばらくぶり	오랜만	0
しんとした	고요한	0
ズイブン	상당히	0
ずい分	상당히	0
ぜっかく	모처럼	0
ゼンブ	전부	0
そういうと	그렇게 말하면	0
そういうところ	그러한 곳	0	//まあそういうところが好きなんだけど
そこんとこ	그 점	1
そこん所	그 점	1
そやけど	그렇지만	0
たぁっぷり	충분히	0
ためつすがめつ	꼼꼼히	0	//シンシアが手紙をためつすがめつ眺める。
ちょっとずつ	조금씩	0
つまるところ	결론적으로	0	//つまるところマスターであるヴァンパイアの眷族です
つまるところは	결론적으로는	0
でもでも	그렇지만 그렇지만	0
どうなりと	어떻게든	0
なーるほど	과-연	0
なおかつ	더 한층	0
なんじょうこと	무슨 일	0	//なんじょうことも侍らず
なんじょうもってこと	무슨 일	0	//なんじょうもってことも侍らず
なんじょうもってのこと	무슨 일	0	//なんじょうもってのことも侍らず
なんじょうもっての事	무슨 일	0	//なんじょうもっての事も侍らず
なんじょうもって事	무슨 일	0	//なんじょうもって事も侍らず
なんじょう事	무슨 일	0	//なんじょう事も侍らず
なんにせよ	어쨌든	0
ひと際	한층 더	0
ほんのわずか	아주 조금	1
ほんの僅か	아주 조금	1
まざまざ	역력	0
まだしも	그래도	0
またぞろ	지겹게 또	0
まるきり	완전	0
まるっきり	완전	0
もう少しだけ	조금만 더	0
ゆっくりと	천천히	0	//ゆっくりと眠りに落ちていった
侃々諤々と	기탄없이	0
綺麗さっぱり	완전히	0	//綺麗さっぱりなくさない内からそんなことする
きれいさっぱり	완전히	0	//きれいさっぱりなくさない内からそんなことする
道々	길을 가면서	0	//そして道々談笑する貴族たち。
毛頭	털끝만큼도	0
斯くして	이리하여	0
斯くて	이리하여	0
斯くも	이렇게도	0
仕し方なき	어쩔 수 없는	0
尚さら	더욱 더	0
嘗て	일찍이	0
尚一層	더 한층	0
尚且つ	더 한층	0
所狭しと	가득	0
時おり	가끔	0
悉く	모조리	0	//ことごとく
沁沁	절절히	0
如何のこうの	이러쿵 저러쿵	0	//如何の斯うの -> 如何のこうの
如何斯う	이러쿵 저러쿵	0
然りとも	그렇다해도	0
然乍ら	마치	0	//さながら
宛ら	마치	0	//さながら
一度たりと	한번도	0
一度たりとも	한번도	0
暫くぶり	오랜만	0
暫く振り	오랜만	0
足繁く	빈번하게	0	//(あししげ)
呪われし	저주 받은	0
失われし	잃어버린	0
止めどとなく	하염없이	0
総て	모두	0	//すべて
兎に角	어쨌든	0
何がさて	하여간	0
何だかんだ	이러니 저러니	0	//何だかんだ言っても
何ゆえ	어찌하여	0
何條こと	무슨 일	0	//何條ことも侍らず
何条こと	무슨 일	0	//何条ことも侍らず
何條もってこと	무슨 일	0	//何條もってことも侍らず
何条もってこと	무슨 일	0	//何条もってことも侍らず
何條もってのこと	무슨 일	0	//何條もってのことも侍らず
何条もってのこと	무슨 일	0	//何条もってのことも侍らず
何條もっての事	무슨 일	0	//何條もっての事も侍らず
何条もっての事	무슨 일	0	//何条もっての事も侍らず
何條もって事	무슨 일	0	//何條もって事も侍らず
何条もって事	무슨 일	0	//何条もって事も侍らず
何條事	무슨 일	0	//何條事も侍らず
何条事	무슨 일	0	//何条事も侍らず
丸きり	완전	0
丸っきり	완전	0
丸っ切り	완전	0
丸切り	완전	0
丸っきし	완전	0
荒ぶる	난폭한	0
いっその事	차라리	0
かっちりした	다부진	0	//そこまでかっちりした躾は受けてないんで
かっちりして	다부져	0
謂われ無い	말할 수 없는	0	//♞謂われ無き
それが故に	그런 연유로	0
程なく	이윽고	0
程無く	이윽고	0
願いたき	부탁하고 싶은	0
にっくき	얄미운	0	//少なくともあたしは練習の時いつもにっくき太陽め、早く沈めって願ってたけど
だ、か、ら	그, 러, 니, 까	0
割りかし	비교적	0
わりかし	비교적	0
矢っ張り	역시	0
全く以て	완전히	0
全くもって	완전히	0
モチロン	물론	1
とてもとても	너무나 너무나	0	//とてもとてもへいわな世界のお話。
今以て	아직도	0
なんやかや	이것저것	0	//なんやかや言われたって、これがいつもの当たり前で、
ちょっくら	조금	0	//ちょっくら大胆に行ってくるっす！
ちょこっと	조금	0	//たかがちょこっと勉強教えてあげただけじゃない
早いとこ	재빨리	0
ぶっきら棒	무뚝뚝	1	//ぶっきら棒な返答。
よーやく	겨우	0
少しばかし	조금	0	//少しばかし調子が良すぎやしねえかい
てんやわんや	야단법석	0
てんやわんやな	야단법석인	0
さぁっさと	빠알리	0
幾ばく	얼마	0	//幾ばくの金を寄付する
紛うことなき	혼동할 일 없는	0
恥ずべき	부끄러워 해야 할	0
有り体に	있는 그대로	0
隈なく	샅샅이	0
成る程	과연	0
成るほど	과연	0
なぁるほど	과연	0
トモカク	어쨌든	1	//가타카나를 상용어구로 하는건 좋지 않음 : 楽しいか楽しくないかはトモカクだ。
とっかえひっかえ	이리 바꾸고 저리 바꾸고	0
たけなわの	절정의	0
たけなわな	절정인	0	//紛争たけなわな頃の東ヨーロッパですわ！
たけなわに	절정에	0	//酒宴がたけなわになったころ
ちょ～っと	조~금	0
恐ろしき	두려운	0
押しなべて	대체로	0
果てなき	끝없는	0
隠密裏に	은밀리에	0
一切合切	모조리	0
いっさいがっさい	모조리	0
滅多に	좀처럼	0
軒並に	집집마다	0
出し抜けの	느닷없는	0
なにゆえ	어째서	0
なにゆえに	어쨰서	0
ちょーっと	조-금	0	//ちょーっとサービスしてあげるわ
万遍なく	구석구석까지	0
万遍無く	구석구석까지	0
満遍無く	구석구석까지	0
満遍なく	구석구석까지	0
漸く	겨우	0

//▰ ~て、~と '부사
チャチャッと	빨리	0
うっそうと	울창하게	0
さくりと	싹둑	0	//トーストをさくりとかじる。
ちょちょいのちょいっと	살짝살짝의 살짝	0
ところ狭しと	가득	0
あらわと	공공연하게	0	//今度は露わとなった小さな割れ目が
あんって	앙	0
イヤイヤと	싫어싫어하고	0
いらっと	울컥	0
うーんと	음	0
うるっと	울컥	0
えへへと	에헤헤	0
えへんと	에헴	0
かあっと	확	0
かくんと	덜컥	0
カッカッと	캇캇	0
かっかっと	캇캇	0
がっしりと	단단하게	0
がしりと	단단하게	0
ガッシリと	단단하게	0
がつんと	콱	0
がつーんと	콰악	0
がばっと	벌떡	0
きちっと	확실히	0
キチンと	제대로	0
ぎゅうぅっと	꽈악	0
ぎゅうって	꾸욱	0
キュウッと	꽈악	0
ぎゅぅっと	꽈악	0
ぎゅうっと	꽈악	0
きゅーんって	쿵	0	//胸がきゅーんってしちゃった！
ぎゅっぎゅと	꾹꾸욱	0
ぎゅって	꽉	0	//んと……ぎゅって持って、ゴシゴシ擦るんだよね？
きゅんきゅんと	뜨끔뜨끔	0
きゅんっと	뜨끔	0
きゅんと	뜨끔	0
キョトンと	어리둥절	0
キョトーンと	어리둥절	0
きょんと	어리둥절	0
きらっと	반짝	0
きりっと	야무지게	0
ぎりっと	으득	0
キリリと	꽉	0
くいっと	꾸욱	0
ぐいっと	꾸욱	0
くくっと	쿠쿡	0
ぐさっと	푸욱	0
ぐすっと	훌쩍	0
ぐちゅって	질척하고	0	//ここにぐちゅって入れて
くちゅっと	질척	0
ぐちゅりと	질척	0
くつくつと	쿡쿡	0
クッパリと	뻐끔	0
くっぱりと	뻐끔	0
ぐにゅっと	물컹	0
グニュリと	물컹	0
ぐにゅりと	물컹	0
くらっと	어찔	0
くりっと	동글	0
グルリと	빙글	0
ぐるりと	빙글	0
くわっと	활짝	0	//くわっと瞳を見開き、
ごきゅっと	꿀꺽	0
こくっと	끄덕	0
ごくりと	꿀꺽	0
こくんと	끄덕	0
こつりと	딱	0
こつんと	딱	0
こてんこてんと	끄덕끄덕	0
ゴボリと	쿨렁	0
ごぼりと	쿨렁	0
こりっと	으득	0
ごりっと	으득	0
ころんと	데굴	0
ごろんと	벌렁	0
さくっと	살짝	0
ざっぱんと	첨벙	0
さらっと	슬쩍	0
サンサンと	찬란히	0
シミジミと	절절히	0
しみじみと	절절히	0
シャキッと	산뜻하게	0
しゃきっと	산뜻하게	0
しゅんっと	슈읏	0
しゅんと	시무룩	0
じりっと	지릿	0
じろっと	힐끗	0
すうっと	스윽	0
ずきっと	욱신	0
ずきりと	욱신	0
ずどんと	쾅	0
ずぶって	즈붓하고	0	//ずぶって差し込んでぇえ……！
ずぶっと	즈붓	0
ずぼっと	푸욱	0
ずらぁっと	줄줄이	0
すらっと	술술	0
ずらっと	줄줄이	0
するっと	스륵	0
ぞくっと	오싹	0
ぞくんっと	오싹	0
ゾロリと	주렁주렁	0
ぞろりと	주렁주렁	0
ぞわっと	오싹	0
たゆんっと	출렁	0
たゆんと	출렁	0
タラリと	추욱	0
ダラリと	축	0
ちぃっと	조금	0
ちゃっちゃと	빨리	0
ちょこんと	툭	0
ちょろっと	찔끔	0
チロッと	살짝	0
ちろっと	살짝	0
ツツッと	쓰윽	0
つつっと	쓰윽	0
てれりと	수줍게	0
どーんと	두둥	0
ドキリと	덜컥	0
とろっと	질척	0
とろんと	몽롱	0
トロンと	몽롱하게	0
ドンドンと	점점	0
にこりと	생긋	0
ニタリと	히죽	0
ニヤリと	힐쭉	0
にょきっと	삐죽이	0
ぬめっと	미끌	0
ヌメリと	미끌	0
ぬるっと	미끌	0
ぱあっと	파앗	0
ぱぁっと	파앗	0	//シルフィーヌはぱぁっと顔をほころばせる。
はぁっと	하앗	0
パクッと	덥썩	0
ぱくっと	덥썩	0
ぱたんと	꽈당	0
ぱっくんと	덥썩	0
びくっと	움찔	0
びくって	움찔	0
ぴくっと	움찔	0
ビクリと	흠칫	0
ピクリと	흠칫	0
ぴくんと	움찔	0
ひくんと	흠칫	0
びくんと	흠칫	0
びしっと	딱	0
ピタリと	꼭	0
ぴちゃっと	피챳	0
ぴっちりと	딱	0
ぴっちりとした	착 밀착된	0	//ぴっちりとした肉唇。
ぴっちりとして	착 밀착되어	0
ぴとっと	딱	0
ヒヤリと	섬뜩	0
びゅくんっと	흠칫	0
びゅくんと	흠칫	0
ひょいっと	폴짝	0
ぴょこっと	깡총	0
ぴょこんと	깡총	0
びりっと	지릿	0
ビリリと	지르르	0
びりりと	지르르	0
ぶあっと	부왁	0
ぷいっと	휙	0
プクッと	볼록	0
ぷくっと	볼록	0
プツリと	뚝	0
ぷつりと	뚝	0
ぷつんと	툭	0
ぶぴゅっと	부퓻	0
ふふっと	후훗	0
ふらっと	훌쩍	0
ぷりっと	탱글	0
ぶるっと	부르릇	0
ブルリと	부르르	0
ぷるんと	말랑말랑	0
ぶるんと	부릉	0
ふわっと	둥실	0
ブワッと	부왁	0
ぶわっと	부왁	0
フワリと	살짝	0
ぺこっと	꾸벅	0
ぺたんと	풀썩	0
ぺちゃっと	페챳	0
ぺろっと	날름	0
べろんと	날름	0
ぽかーんと	머-엉	0
ぼけっと	멍하니	0
ぼこりと	볼록	0
ぼそっと	멀거니	0
ぽそりと	나지막히	0
ぼっと	멍하니	0
ポツンと	우두커니	0
ぽつんと	우두커니	0
ぽろっと	투욱	0
ほわっと	둥실	0
まざまざと	역력하게	0
マッタリと	느긋하게	0
むぎゅっと	물컹	0
むくっと	벌떡	0
むにゅっと	물컹	0
むにゅんと	물렁	0
むらっと	므흣	0
むんずと	꽉	0
ゆるりと	천천히	0
ヨシヨシと	좋아좋아	0
苛っと	울컥	0
負けじと	지지 않으려고	0沸々と	부글부글	0	//ぶつぶつ
深々と	깊숙히	0
寒々と	으스스	0
沁沁と	절절히	0
染染と	절절히	0
丸丸と	토실토실	0
活き活きと	생생하게	0
ひっそりと	고요하게	0
ヒッソリと	고요하게	0
きょとんと	어리둥절	0
はらりと	사르르	0
ハラリと	사르르	0
ボケッと	멍하니	0	//ボケッとしてるから
ずしりと	묵직하게	0
ひっしと	필사적으로	0	//ひっしと抱きついた
のそりと	느릿하게	0
ぱしっと	퍽	0
冷やっと	오싹	0
ひやっと	오싹	0
しれっと	태연히	0	//しれっと答えたすみれは、針金らしき物を俺に見せてきた。
ぴくって	움찔	0
ぬぼーっと	멍하니	0
ぷにっと	말랑	0
ぷにーっと	말랑	0
ずばっと	푸욱	0
ずばーっと	푸욱	0
はつらつと	발랄하게	0
つつーっと	쓰-윽	0
そーっと	살짝	0
つるんと	주륵	0
からっと	활짝	0
からーっと	활짝	0	//明日も同じようにからっと晴れてくれるらしい。
きゅうぅって	꽈악	0
きゅうって	꽈악	0
きゅうっと	꽈악	0
ほのぼのと	따끈따끈	0
ツツーッと	쓰-윽	0
きゅっと	꽉	0
きゅーっと	꽉	0
きゅんきゅんって	큥큥하고	0
ぴくんっと	움찔	0
ぴくんって	움찔	0
ぷつんて	툭	0	//張り詰めた糸がぷつんて切れちゃいそうなの。
ぷつんって	툭	0
ちゃちゃっと	빨리	0
ざくっと	스윽[ざくっと]	0	//ざくっと行くか
ホイホイと	척척	0
じゃらっと	좌락	0
さんじゃらっと	조금	0
ずずずっと	즈즈즛	0
ずずっと	즈즛	0
びびっと	찌릿	0
ぱぱっと	파팟	0
こそっと	살며시	0
だらんと	축	0	//だらんとベッドの下へと降ろした。
どくんと	두근	0
ぷりんと	포동	0
ぽけーっと	멍하게	0
ぽけっと	멍하게	0
ぽやんと	멍하게	0
ぽやーんと	멍하게	0
ぴちょんと	똑	0
ちょんと	슬쩍[ちょんと]	0
すっくと	우뚝	0
にへらっと	헤벌죽	0
にへらと	헤벌죽	0
ぷよんと	말랑	0
くたりと	축	0
たんたんと	담담히	0
ざらりと	가칠가칠	0
ぽいっと	휙	0
ぷしゅーって	푸슛	0
ぷしゅって	푸슛	0
一歩二歩と	한 걸음 두 걸음	0	//俺から一歩二歩と離れて振り返り、
じとっと	음습하게	0
じとーっと	음습하게	0
ころっと	홀랑	0	//ころっと忘れていた。
ちょこちょこっと	촐랑촐랑	0
うぐっと	우긋	0	//うぐっと言葉に詰まってしまう。序列はもうぐっと上がる。
ぶつりと	툭	0	//警告音もぶつりと途切れる。
ふんっと	흥	0	//俺を見下ろしたユカはふんっと鼻を鳴らす。
ぺこんと	꾸벅	0	//ぺこんとお辞儀する。
//ぽっと	멍하니	1	//안 하는게 좋을 듯 하다. **ぽっと出
ぽーっと	멍하니	0
ぼーっと	멍-하니	0
ぼおーっと	멍-하니	0
ぼおっと	멍하니	0
ぼぉーっと	멍-하니	0
ぼぉっと	멍하니	0
ぷるんっと	탱글	0
うすっらと	희미하게	0	//원래 うっすらと 인데, 자주 나오는 오타라 입력.
ひょこっと	불쑥	0
じゅっと	바지직	0
ほけっと	멍하니	0
ぷくりと	봉긋	0
もぞりと	꿈지럭	0
ばたりと	툭	0
するーっと	스-륵	0
ぼやっと	멍하니	0
ぽやっと	멍하니	0
かくんっと	털썩	0
じゅわっと	쥬왓	0
ごろーっと	데-굴	0
どかーんと	쾅	0	//どかーんとテーブルに置かれたパーティ皿。
どかーんっと	쾅	0
どぼーんと	풍덩	0
どぼーんっと	풍덩	0
ぱぱーっと	파-팟	0
ぺたっと	찰싹	0	//リアがぺたっとくっついてくる。
ぺたんっと	털썩	0
すすりと	후루룩	0
ちゃらんぽらんと	대강대강	0
チャランボランと	대강대강	0
ずずいっと	스슥	0	//いきなりみんなずずいっと顔を寄せてきた。
ざざっと	사삭	0
かっくりと	털썩	0
ごくんと	꿀꺽	0
がらっと	스윽	0	//顔の印象ががらっと変わっちゃうから
いけしゃあしゃあと	뻔뻔스럽게	0
ジロジロッと	빤히	0
ボソリと	중얼	0
むすっと	시무룩	0
ぷっつんと	툭	0
ぽうっと	멍하니	0
きゃぴっと	상큼	0	//俺はキャピっとウインク。
キャピッと	상큼	0	//俺はキャピっとウインク。
しらっと	썰렁	0
ずるっと	주륵	0
えっへんと	에헴	0
うへぇと	우헤에	0
ぽこっと	툭	0
ぐえって	구엣	0
うふふと	우후후	0
うふふっと	우후훗	0
懇々と	간곡히	0
ひょこんと	툭	0
ぐらりと	기우뚱	0
きゅぅっと	꾸욱	0
さらさらと	졸졸	0
へらりと	헤죽	0
ぐちょっと	질척	0
べちゃっと	질척	0
ツルリと	반들반들	0
まるっと	통째로	0
うんうんと	응응	0
にゃははと	냐하하	0
ぶるんっと	부릉	0
どおんと	두웅	0
ちゅっと	츗	0
ふにゃっと	말랑	0
ふにゃって	말랑	0
じょろっと	졸졸	0
ほろりと	글썽	0
ぞっくと	오싹	0
明々と	환하게	0
ちゃらりと	짤랑	0
くらりと	어찔	0
ぼとりと	푹	0
ボトリと	푹	0
ぞくって	오싹	0
びゅくって	뷰쿳	0
むわっと	므왓[むわっと]	0
ざらっと	까끌	0
ぽすんと	툭	0
よろりと	비틀	0
ごそりと	살그머니	0
ぽよんと	말랑	0
べしゃんと	풀썩	0
むすりと	무뚝뚝하게	0
ぐたりと	축	0
ゴブゴブと	부글부글	0	//ゴブゴブと、赤紫の血が流れ出る。
せっせと	부지런히	0
せっせっと	부지런히	0
二ヤリと	생긋	0
ふんふんと	흥흥	0
がつんっと	퍼억	0
どろっと	주륵	0
でろっと	걸죽	0
ぺろんって	날름 하고	0

//▰ ABxB형 '부사 (번역어도 ABxB임)
うしうし	좋아좋아∥t	0
ぷにっぷに	말랑말랑∥t	0
プリップリ	탱탱∥t	0
コリッコリ	오돌오돌∥t	0
ちゅぷっちゅぷっ	츄풋츄풋∥t	0
がっちがち	딱딱∥t	0
しゅわしゅわ	슈와슈와∥t	0
けちょんけちょん	딱콩딱콩∥t	0
すたかた	성큼성큼∥t	0
すったかた	성큼성큼∥t	0	//婦警さんはすったかたと去っていく
スタカタ	성큼성큼∥t	0
スッタカタ	성큼성큼∥t	0
アタフタ	허둥지둥∥t	0
アチアチ	후끈후끈∥t	0
あちあち	후끈후끈∥t	0
アチアチッ	후끈후끈∥t	0
アツアツ	후끈후끈∥t	0
あつあつ	후끈후끈∥t	0
アツアツッ	후끈후끈∥t	0
アムアム	얌얌∥t	0
あむあむ	얌얌∥t	0
アンアン	앙앙∥t	0
あんあん	앙앙∥t	0
イガイガ	거칠거칠∥t	0
いがいが	거칠거칠∥t	0
イジイジ	쭈뼛쭈뼛∥t	0
いじいじ	쭈뼛쭈뼛∥t	0
イチャイチャ	러브러브∥t	0
いちゃいちゃ	러브러브∥t	0
イボイボ	오돌오돌∥t	0
いぼいぼ	오돌오돌∥t	0
イライラ	안절부절∥t	0
いらいら	안절부절∥t	0
//ウィンウィン	윙윙∥t	0	//"win win"
うぃんうぃん	윙윙∥t	0
ウインウイン	윙윙∥t	0
ういんういん	윙윙∥t	0
//ウィンウィンッ	윙윙∥t	0	//"win win"
ウインウインッ	윙윙∥t	0
ウカウカ	엄벙덤벙∥t	0
うかうか	엄벙덤벙∥t	0
ウキウキ	울렁울렁∥t	0
うきうき	울렁울렁∥t	0
ウジウジ	머뭇머뭇∥t	0
うじうじ	머뭇머뭇∥t	0
ウズウズ	근질근질∥t	0
うずうず	근질근질∥t	0
ウダウダ	궁시렁궁시렁∥t	0
うだうだ	궁시렁궁시렁∥t	0
ウツラウツラ	꾸벅꾸벅∥t	0
ウニウニ	지끈지끈∥t	0
うにうに	지끈지끈∥t	0
ウネウネ	꾸불꾸불∥t	0
ウムウム	음음∥t	0
うむうむ	음음∥t	0
ウルウル	글썽글썽∥t	0
うるうる	글썽글썽∥t	0
ウロウロ	우왕좌왕∥t	0
ウロチョロ	얼쩡얼쩡∥t	0
うろちょろ	얼쩡얼쩡∥t	0
ウンウン	응응∥t	0
えーんえーん	엥엥∥t	0
おいでおいで	이리와 이리와∥t	0
おぎゃぁおぎゃぁ	응애응애∥t	0
おぎゃあおぎゃあ	응애응애∥t	0
オギャオギャ	응애응애∥t	0
おぎゃおぎゃ	응애응애∥t	0
オズオズ	흠칫흠칫∥t	0
オタオタ	허둥지둥∥t	0
おたおた	허둥지둥∥t	0
オドオド	흠칫흠칫∥t	0
おどおど	흠칫흠칫∥t	0
オロオロ	허둥지둥∥t	0
ガクガク	삐걱삐걱∥t	0
がくがく	삐걱삐걱∥t	0
ガクガクッ	삐걱삐걱∥t	0
ガクンガクン	덜컥덜컥∥t	0
がくんがくん	덜컥덜컥∥t	0
ガクンガクンッ	덜컥덜컥∥t	0
ガサガサ	부스럭부스럭∥t	0
がさがさ	부스럭부스럭∥t	0
ガサガサッ	부스럭부스럭∥t	0
カサコソ	바스락바스락∥t	0
ガサゴソ	부스럭부스럭∥t	0
がさごそ	부스럭부스럭∥t	0
ガサゴソッ	부스럭부스럭∥t	0
ガサバサ	부스럭부스럭∥t	0
がさばさ	부스럭부스럭∥t	0
ガサバサッ	부스럭부스럭∥t	0
ガシガシ	슥싹슥싹∥t	0
がしがし	슥싹슥싹∥t	0
カシャカシャ	찰칵찰칵∥t	0
かしゃかしゃ	찰칵찰칵∥t	0
カシャカシャッ	찰칵찰칵∥t	0
カシャッカシャッ	찰칵찰칵∥t	0
かしゃっかしゃっ	찰칵찰칵∥t	0
かすれがすれ	가랑가랑∥t	0
カタカタ	달각달각∥t	0
かたかた	달각달각∥t	0
ガタッガタッ	덜컹덜컹∥t	0
がたっがたっ	덜컹덜컹∥t	0
カチカチ	딱딱∥t	0
かちかち	딱딱∥t	0
ガチガチ	딱딱∥t	0	//(딱딱한 물체가 부딪치는 소리)
がちがち	딱딱∥t	0	//(딱딱한 물체가 부딪치는 소리)
ガチガチッ	딱딱∥t	0	//(딱딱한 물체가 부딪치는 소리)
ガチムチ	울끈불끈∥t	0
がちむち	울끈불끈∥t	0
ガチャガチャ	절컥절컥∥t	0
がちゃがちゃ	절컥절컥∥t	0
カチャカチャ	찰칵찰칵∥t	0
かちゃかちゃ	찰칵찰칵∥t	0
ガチャガチャッ	절컥절컥∥t	0
カチャカチャッ	찰칵찰칵∥t	0
カチャッカチャッ	찰칵찰칵∥t	0
かちゃっかちゃっ	찰칵찰칵∥t	0
ガツガツ	걸근걸근∥t	0
カツカツ	빠듯빠듯∥t	0
かつかつ	빠듯빠듯∥t	0
ガックンガックン	덜컥덜컥∥t	0
がっくんがっくん	덜컥덜컥∥t	0
ガックンガックンッ	덜컥덜컥∥t	0
カッチカチ	딱딱∥t	0
ガッチガチ	딱딱∥t	0
ガッチガッチ	딱딱∥t	0	//(딱딱한 물체가 부딪치는 소리)
がっちがっち	딱딱∥t	0	//(딱딱한 물체가 부딪치는 소리)
ガツンガツン	퍼억퍼억∥t	0
がつんがつん	퍼억퍼억∥t	0
ガツンガツンッ	퍼억퍼억∥t	0
ガバガバ	헐렁헐렁∥t	0
ガビガビ	푸석푸석∥t	0
がびがび	푸석푸석∥t	0
ガミガミ	군시렁 군시렁∥t	0
カラコロ	딸깍딸깍∥t	0
カラコロン	딸랑딸랑∥t	0
カランコロン	딸랑딸랑∥t	0
ガリガリ	으득으득∥t	0
がりがり	으득으득∥t	0
カリカリ	파삭파삭∥t	0
かりかり	파삭파삭∥t	0
キイキイ	키이키이∥t	0
キシキシ	삐걱삐걱∥t	0
きしきし	삐걱삐걱∥t	0
ギシギシ	삐걱삐걱∥t	0
ぎしぎし	삐걱삐걱∥t	0
ギシギシッ	삐걱삐걱∥t	0
ギスギス	깨깨∥t	0
ぎすぎす	깨깨∥t	0
ギタギタ	진득진득∥t	0
ぎたぎた	진득진득∥t	0
ギチギチ	삐걱삐걱∥t	0
キツキツ	바둥바둥∥t	0
きつきつ	바둥바둥∥t	0
ギッシギッシ	삐걱삐걱∥t	0
ぎっしぎっし	삐걱삐걱∥t	0
ギッタンギッタン	퍼벅퍼벅∥t	0
ぎったんぎったん	퍼벅퍼벅∥t	0
ギトギト	번들번들∥t	0
ぎとぎと	번들번들∥t	0
キビキビ	시원시원∥t	0
きびきび	시원시원∥t	0
キャァキャァ	꺄아꺄아∥t	0	//(놀랍고 무서워서 내는 소리. 장난치며 떠드는 소리)
きゃぁきゃぁ	꺄아꺄아∥t	0	//(놀랍고 무서워서 내는 소리. 장난치며 떠드는 소리)
キャアキャア	꺄아꺄아∥t	0	//(놀랍고 무서워서 내는 소리. 장난치며 떠드는 소리)
きゃあきゃあ	꺄아꺄아∥t	0	//(놀랍고 무서워서 내는 소리. 장난치며 떠드는 소리)
ギャァギャァ	꺄아꺄아∥t	0	//(놀랍고 무서워서 내는 소리. 장난치며 떠드는 소리)
ぎゃぁぎゃぁ	꺄아꺄아∥t	0	//(놀랍고 무서워서 내는 소리. 장난치며 떠드는 소리)
ギャアギャア	꺄아꺄아∥t	0	//(놀랍고 무서워서 내는 소리. 장난치며 떠드는 소리)
ぎゃあぎゃあ	꺄아꺄아∥t	0	//(놀랍고 무서워서 내는 소리. 장난치며 떠드는 소리)
ぎゃーぎゃー	꺄-꺄-∥t	0	//(놀랍고 무서워서 내는 소리. 장난치며 떠드는 소리)
キャピキャピ	상큼상큼∥t	0
きゃぴきゃぴ	상큼상큼∥t	0
ギャフン	갸흥∥t	0
ぎゃふん	갸흥∥t	0
キュウキュウ	큐우큐우∥t	0
きゅうきゅう	큐우큐우∥t	0
きゅぅきゅぅ	큐우큐우∥t	0
キュッキュッ	꼬옥꼬옥∥t	0
ギュッギュッ	꾹꾹∥t	0
ぎゅっぎゅっ	꾹꾹∥t	0
きゅっきゅっ	꼬옥꼬옥∥t	0
ギュンギュン	꾸욱꾸욱∥t	0
ぎゅんぎゅん	꾸욱꾸욱∥t	0
キョロキョロ	두리번두리번∥t	0
ギラギラ	번득번득∥t	0	//(놀랍고 무서워서 내는 소리. 장난치며 떠드는 소리)
ぎらぎら	번득번득∥t	0	//(놀랍고 무서워서 내는 소리. 장난치며 떠드는 소리)
キラキラッ	반짝반짝∥t	0
ギラギラッ	번득번득∥t	0	//(놀랍고 무서워서 내는 소리. 장난치며 떠드는 소리)
ギンギン	끙끙∥t	0
ぎんぎん	끙끙∥t	0
クイクイ	꾹꾹∥t	0
グイグイ	쭉쭉∥t	0
ぐいぐい	쭉쭉∥t	0
クイクイッ	꾹꾹∥t	0
クイックイッ	꾸욱꾸욱∥t	0
グイングイン	휘익휘익∥t	0
ぐいんぐいん	휘익휘익∥t	0
グウグウ	쿨쿨∥t	0
グサグサ	푸욱푸욱∥t	0
ぐさぐさ	푸욱푸욱∥t	0
グジグジ	투덜투덜∥t	0
ぐじぐじ	투덜투덜∥t	0
クシャクシャ	꾸깃꾸깃∥t	0
くしゃくしゃ	꾸깃꾸깃∥t	0
グシャグシャ	뭉글뭉글∥t	0
ぐしゃぐしゃ	뭉글뭉글∥t	0
グシュグシュ	주륵주륵∥t	0
ぐしゅぐしゅ	주륵주륵∥t	0
グジュグジュ	훌쩍훌쩍∥t	0
ぐじゅぐじゅ	훌쩍훌쩍∥t	0
グショグショ	흠뻑흠뻑∥t	0
ぐしょぐしょ	흠뻑흠뻑∥t	0
グズグズ	꾸물꾸물∥t	0
ぐずぐず	꾸물꾸물∥t	0
クスクスッ	키득키득∥t	0
グダグダ	구질구질∥t	0
ぐだぐだ	구질구질∥t	0
クタクタ	기진맥진∥t	0
グチグチ	궁시렁궁시렁∥t	0
ぐちぐち	궁시렁궁시렁∥t	0
クチクチ	질퍽질퍽∥t	0
くちくち	질퍽질퍽∥t	0
クチュックチュッ	질척질척∥t	0
クツクツ	쿡쿡∥t	0
くつくつ	쿡쿡∥t	0
ぐっちょぐちょ	질척질척∥t	0
グッポグッポ	굽포굽포∥t	0
ぐっぽぐっぽ	굽포굽포∥t	0
クドクド	주절주절∥t	0
くどくど	주절주절∥t	0
グナグナ	물컹물컹∥t	0
ぐなぐな	물컹물컹∥t	0
クナクナ	하늘하늘∥t	0
クニクニ	만지작만지작∥t	0
くにくに	만지작만지작∥t	0
グニグニ	슥슥∥t	0
ぐにぐに	슥슥∥t	0
クニクニッ	만지작만지작∥t	0
グニグニッ	슥슥∥t	0
ぐにゃぐにゃ	흐늘흐늘∥t	0
グニヤグニャ	흐늘흐늘∥t	0
グニュグニュ	말랑말랑∥t	0
ぐにゅぐにゅ	말랑말랑∥t	0
グニングニン	몰캉몰캉∥t	0
ぐにんぐにん	몰캉몰캉∥t	0
グニングニンッ	몰캉몰캉∥t	0
クネクネ	구불구불∥t	0
くねくね	구불구불∥t	0
グネグネ	구불구불∥t	0
ぐねぐね	구불구불∥t	0
クネクネッ	구불구불∥t	0
グネグネッ	구불구불∥t	0
クパクパ	움찔움찔∥t	0
くぱくぱ	움찔움찔∥t	0
グビグビ	꿀걱꿀걱∥t	0
グプグプ	부글부글∥t	0
ぐぷぐぷ	부글부글∥t	0
クヨクヨ	끙끙∥t	0
グラグラ	흔들흔들∥t	0
クリクリ	동글동글∥t	0
くりくり	동글동글∥t	0
グリグリ	동글동글∥t	0
ぐりぐり	동글동글∥t	0
クリクリッ	동글동글∥t	0
グリグリッ	동글동글∥t	0
グルングルン	빙글빙글∥t	0
ぐるんぐるん	빙글빙글∥t	0
グワングワン	구웅구웅∥t	0
ぐわんぐわん	구웅구웅∥t	0
グングン	부쩍부쩍∥t	0
ゲシゲシ	퍽퍽∥t	0
げしげし	퍽퍽∥t	0
ゲシゲシッ	퍽퍽∥t	0
ケタケタ	낄낄∥t	0
ケホケホ	콜록콜록∥t	0
けほけほ	콜록콜록∥t	0
ゲホゲホ	콜록콜록∥t	0
げほげほ	콜록콜록∥t	0
ケホケホッ	콜록콜록∥t	0
ゲホゲホッ	콜록콜록∥t	0
ケホンケホン	콜록콜록∥t	0
けほんけほん	콜록콜록∥t	0
ゲホンゲホン	콜록콜록∥t	0
げほんげほん	콜록콜록∥t	0
ケホンケホンッ	콜록콜록∥t	0
ゲホンゲホンッ	콜록콜록∥t	0
ケロケロ	개굴개굴∥t	0
けろけろ	개굴개굴∥t	0
ゲロゲロ	개굴개굴∥t	0
げろげろ	개굴개굴∥t	0
ケロケロッ	개굴개굴∥t	0
ゲロゲロッ	개굴개굴∥t	0
ゴウゴウ	시끌시끌∥t	0
ごうごう	시끌시끌∥t	0
ゴキゴキ	뽀각뽀각∥t	0
ごきごき	뽀각뽀각∥t	0
コキコキ	우득우득∥t	0
こきこき	우득우득∥t	0
ゴキュゴキュ	꿀꺽꿀꺽∥t	0
ごきゅごきゅ	꿀꺽꿀꺽∥t	0
コクコク	끄덕끄덕∥t	0
こくこく	끄덕끄덕∥t	0
コクコクッ	끄덕끄덕∥t	0
コシコシ	슥슥∥t	0
こしこし	슥슥∥t	0
ゴシゴシ	쓱쓱∥t	0
ごしごし	쓱쓱∥t	0
ゴシャゴシャ	뒤죽박죽∥t	0
ごしゃごしゃ	뒤죽박죽∥t	0
ゴソゴソ	바스락바스락∥t	0
コソコソ	소근소근∥t	0
ゴチャゴチャ	뒤죽박죽∥t	0
コチョコチョ	간질간질∥t	0
こちょこちょ	간질간질∥t	0
ゴツゴツ	울퉁불퉁∥t	0
コツコツ	톡톡∥t	0
こつこつ	톡톡∥t	0
ゴッツンゴッツン	터억터억∥t	0
ごっつんごっつん	터억터억∥t	0
ゴツンゴツン	터억터억∥t	0
ごつんごつん	터억터억∥t	0
コテコテ	덕지덕지∥t	0
こてこて	덕지덕지∥t	0
コトコト	달각달닥∥t	0
ことこと	달각달닥∥t	0
ゴニョゴニョ	소근소근∥t	0
ごにょごにょ	소근소근∥t	0
コポコポ	보글보글∥t	0
こぽこぽ	보글보글∥t	0
コホコホ	콜록콜록∥t	0
こほこほ	콜록콜록∥t	0
ゴホゴホ	쿨럭쿨럭∥t	0
ごほごほ	쿨럭쿨럭∥t	0
ゴボゴボ	쿨렁쿨렁∥t	0
ごぼごぼ	쿨렁쿨렁∥t	0
コホコホッ	콜록콜록∥t	0
ゴホゴホッ	쿨럭쿨럭∥t	0
ゴボゴボッ	쿨렁쿨렁∥t	0
コホッコホッ	콜록콜록∥t	0
こほっこほっ	콜록콜록∥t	0
ゴホッゴホッ	쿨럭쿨럭∥t	0
ごほっごほっ	쿨럭쿨럭∥t	0
コホンコホン	콜록콜록∥t	0
こほんこほん	콜록콜록∥t	0
ゴホンゴホン	쿨럭쿨럭∥t	0
ごほんごほん	쿨럭쿨럭∥t	0
コホンコホンッ	콜록콜록∥t	0
ゴホンゴホンッ	쿨럭쿨럭∥t	0
ゴリゴリ	빠득빠득∥t	0
ごりごり	빠득빠득∥t	0
コリコリ	오돌오돌∥t	0
こりこり	오돌오돌∥t	0
コリゴリ	지긋지긋∥t	0
こりごり	지긋지긋∥t	0
ゴロゴロ	뒹굴뒹굴∥t	0
ごろごろ	뒹굴뒹굴∥t	0
ゴロゴロン	뒹굴뒹굴∥t	0
ごろごろん	뒹굴뒹굴∥t	0
ゴロンゴロン	뒹굴뒹굴∥t	0
ごろんごろん	뒹굴뒹굴∥t	0
ゴワゴワ	뻣뻣∥t	0
ごわごわ	뻣뻣∥t	0
コワコワ	오싹오싹∥t	0
こわこわ	오싹오싹∥t	0
ゴンゴン	댕댕∥t	0
ごんごん	댕댕∥t	0
コンコン	콩콩∥t	0
こんこん	콩콩∥t	0
コンコンコン	콩콩콩∥t	0
こんこんこん	콩콩콩∥t	0
コンコンッ	콩콩∥t	0
サクサク	사각사각∥t	0
さくさく	사각사각∥t	0
ザクザク	서걱서걱∥t	0
ざくざく	서걱서걱∥t	0
ザクザクッ	서걱서걱∥t	0
ザックザク	서걱서걱∥t	0
ザックザクッ	서걱서걱∥t	0
ざっくざっく	서걱서걱∥t	0
ザッザッ	삭삭∥t	0
ざっざっ	삭삭∥t	0
ザッパンザッパン	첨벙첨벙∥t	0
ざっぱんざっぱん	첨벙첨벙∥t	0
サバサバ	시원시원∥t	0
さばさば	시원시원∥t	0
さらさらさら	줄줄줄∥t	0
サワサワ	산들산들∥t	0
サワサワサワ	산들산들산들∥t	0
さわさわ	산들산들∥t	0
さわさわさわ	산들산들산들∥t	0
ザワザワ	술렁술렁∥t	0
ざわざわ	술렁술렁∥t	0
ジクジク	질척질척∥t	0
シクシク	훌쩍훌쩍∥t	0
シコシコ	쫄깃쫄깃∥t	0
シズシズ	조용조용∥t	0
ジタバタ	바동바동∥t	0
ジトジト	눅진눅진∥t	0
じとじと	눅진눅진∥t	0
ジメジメ	눅진눅진∥t	0
じめじめ	눅진눅진∥t	0
シャアシャア	솨아솨아∥t	0
しゃあしゃあ	솨아솨아∥t	0
シャイシャイ	샤이샤이∥t	0
シャカシャカ	사각사각∥t	0
しゃかしゃか	사각사각∥t	0
シャキシャキ	척척∥t	0
ジャラジャラ	짤랑짤랑∥t	0
ジャリジャリ	자그락자그락∥t	0
じゃりじゃり	자그락자그락∥t	0
ジャンジャン	척척∥t	0
ジュージュー	지글지글∥t	0
ジュクジュク	질퍽질퍽∥t	0
じゅくじゅく	질퍽질퍽∥t	0
ジュクジュクッ	질퍽질퍽∥t	0
ジュックジュック	질퍽질퍽∥t	0
じゅっくじゅっく	질퍽질퍽∥t	0
シュッシュッ	슉슉∥t	0
しゅっしゅっ	슉슉∥t	0
ジュップジュップ	질퍽질퍽∥t	0
じゅっぷじゅっぷ	질퍽질퍽∥t	0
ジュブジュブ	쥬웁쥬웁∥t	0
じゅぶじゅぶ	쥬웁쥬웁∥t	0
ジュプジュプ	질퍽질퍽∥t	0
じゅぷじゅぷ	질퍽질퍽∥t	0
ジュプジュプッ	질퍽질퍽∥t	0
ジュポジュポ	쭈웁쭈웁∥t	0
じゅぽじゅぽ	쭈웁쭈웁∥t	0
ジュルジュル	줄줄∥t	0
じゅるじゅる	줄줄∥t	0
ジョキジョキ	사각사각∥t	0
じょきじょき	사각사각∥t	0
ショボショボ	보슬보슬∥t	0
ジョボジョボ	졸졸∥t	0
じょぼじょぼ	졸졸∥t	0
ジョリジョリ	까끌까끌∥t	0
じょりじょり	까끌까끌∥t	0
ジリジリ	바작바작∥t	0
じりじり	바작바작∥t	0
シワクチャ	쪼글쪼글∥t	0
しわくちゃ	쪼글쪼글∥t	0
ジワジワ	서서히	0
シワシワ	쭈글쭈글∥t	0
しわしわ	쭈글쭈글∥t	0
ジワジワと	서서히	0
ジワリジワリ	차츰차츰∥t	0
ジンジン	지릿지릿∥t	0
じんじん	지릿지릿∥t	0
ズイズイ	즈욱즈욱∥t	0
ずいずい	즈욱즈욱∥t	0
スゥスゥ	스으스으∥t	0
すぅすぅ	스으스으∥t	0
スウスウ	스으스으∥t	0
すうすう	스으스으∥t	0
スースー	스으스으∥t	0
すーすー	스으스으∥t	0
スーズー	스으즈으∥t	0
ズカズカ	성큼성큼∥t	0
ずかずか	성큼성큼∥t	0
スカスカ	척척∥t	0
すかすか	척척∥t	0
ズカズカッ	성큼성큼∥t	0
ズギュンズギュン	즈귱즈귱∥t	0
ずぎゅんずぎゅん	즈귱즈귱∥t	0
ズキンズキン	욱신욱신∥t	0
ずきんずきん	욱신욱신∥t	0
スクスク	쑥쑥∥t	0
すくすく	쑥쑥∥t	0
ズクズク	질퍽질퍽∥t	0
ずくずく	질퍽질퍽∥t	0
スケスケ	보일듯 말듯∥t	0
すけすけ	보일듯 말듯∥t	0
ズケズケ	성큼성큼∥t	0
ずけずけ	성큼성큼∥t	0
スゴスゴ	터벅터벅∥t	0
すごすご	터벅터벅∥t	0
ズジュズジュ	즈쥬즈쥬∥t	0
ずじゅずじゅ	즈쥬즈쥬∥t	0
ズタズタ	갈기갈기∥t	1
スタスタ	총총∥t	0
すたすた	총총∥t	0
ズタボロ	너덜너덜∥t	0
ずたぼろ	너덜너덜∥t	0
ズッコンバッコン	붕가붕가∥t	0
ずっこんばっこん	붕가붕가∥t	0
ズッボズッボ	쑤컹쑤컹∥t	0
ずっぼずっぼ	쑤컹쑤컹∥t	0
ズッポズッポ	쑤컹쑤컹∥t	0
ずっぽずっぽ	쑤컹쑤컹∥t	0
スバスバ	뻑뻑∥t	0
すばすば	뻑뻑∥t	0
ズバズバ	성큼성큼∥t	0
ずばずば	성큼성큼∥t	0
スブズブ	푸욱푸욱∥t	0
すぶずぶ	푸욱푸욱∥t	0
ズブズブ	푸욱푸욱∥t	0
ずぶずぶ	푸욱푸욱∥t	0
ズブズブッ	푸욱푸욱∥t	0
ズボズボ	쑤컹쑤컹∥t	0
ずぼずぼ	쑤컹쑤컹∥t	0
ズポズポ	쑤컹쑤컹∥t	0
ずぽずぽ	쑤컹쑤컹∥t	0
ズボズボッ	쑤컹쑤컹∥t	0
ズポズポッ	쑤컹쑤컹∥t	0
ズボッズボッ	쑤컹쑤컹∥t	0
ずぼっずぼっ	쑤컹쑤컹∥t	0
ズポッズポッ	쑤컹쑤컹∥t	0
ずぽっずぽっ	쑤컹쑤컹∥t	0
スヤスヤ	새근새근∥t	0
スラスラ	술술∥t	0
スリスリ	부비부비∥t	0
すりすり	부비부비∥t	0
ズリズリ	주륵주륵∥t	0
ずりずり	주륵주륵∥t	0
ズリュズリュ	즈릅즈릅∥t	0
ずりゅずりゅ	즈릅즈릅∥t	0
スルスル	술술∥t	0
スルスルッ	술술∥t	0
スレスレ	아슬아슬∥t	0
すれすれ	아슬아슬∥t	0
ズンズン	부쩍부쩍∥t	0
ずんずん	부쩍부쩍∥t	0
スンスン	슝슝∥t	0
すんすん	슝슝∥t	0
スンッスンッ	슝슝∥t	0
ゾクゾク	오슬오슬∥t	0
ぞくぞく	오슬오슬∥t	0
ゾクゾクッ	오슬오슬∥t	0
ゾリゾリ	스윽스윽∥t	0
ぞりぞり	스윽스윽∥t	0
ソロソロ	슬슬∥t	0
そろそろ	슬슬∥t	0
ゾロゾロ	줄줄∥t	0
ぞろぞろ	줄줄∥t	0
ソロソロッ	슬슬∥t	0
ソロリソロリ	슬금슬금∥t	0
そろりそろり	슬금슬금∥t	0
ソワソワ	안절부절∥t	0
ゾワゾワ	움찔움찔∥t	0
ぞわぞわ	움찔움찔∥t	0
タジタジ	비틀비틀∥t	0
タトタト	토닥토닥∥t	0
たとたと	토닥토닥∥t	0
ダブダブ	출렁출렁∥t	0
だぶだぶ	출렁출렁∥t	0
タユタユ	찰랑찰랑∥t	0
たゆたゆ	찰랑찰랑∥t	0
タラタラ	주룩주룩∥t	0
たらたら	주룩주룩∥t	0
ダラダラ	질질∥t	0
だらだら	질질∥t	0
チカチカ	반짝반짝∥t	0
チクタク	똑딱똑딱∥t	0
ちくたく	똑딱똑딱∥t	0
ちくはぐ	뒤죽박죽∥t	0
チグハグ	뒤죽박죽∥t	0
チッチッ	칫칫∥t	0
チビリチビリ	찔끔찔끔∥t	0
ちびりちびり	찔끔찔끔∥t	0
チマチマ	조촐조촐∥t	0
ちまちま	조촐조촐∥t	0
ちゃきちゃき	착착∥t	0
チャキチャキ	챠키챠키∥t	0
チャクチャク	착착∥t	0
ちゃくちゃく	착착∥t	0
チャプチャプ	첨벙첨벙∥t	0
ちゃぷちゃぷ	첨벙첨벙∥t	0
チャプチャプッ	첨벙첨벙∥t	0
チャプンチャプン	첨벙첨벙∥t	0
ちゃぷんちゃぷん	첨벙첨벙∥t	0
チャプンチャプンッ	첨벙첨벙∥t	0
チヤホヤ	오냐오냐∥t	0
ちやほや	오냐오냐∥t	0
チャラチャラ	짤랑짤랑∥t	0
チュクチュク	따끔따끔∥t	0
ちゅくちゅく	따끔따끔∥t	0
チュチュ	츄츄∥t	0
ちゅちゅ	츄츄∥t	0
チュッチュッ	츗츗∥t	0
ちゅっちゅっ	츗츗∥t	0
ぢゅぷぢゅぷ	쥬브쥬브∥t	0
チュルチュル	츄룹츄룹∥t	0
ちゅるちゅる	츄룹츄룹∥t	0
チョイチョイ	살짝살짝∥t	0
ちょいちょい	살짝살짝∥t	0
ちょちょい	살짝살짝∥t	0
チョキチョキ	싹둑싹둑∥t	0
ちょきちょき	싹둑싹둑∥t	0
チョコチョコ	총총∥t	0
チョコマカ	촐랑촐랑∥t	0
ちょこまか	촐랑촐랑∥t	0
チョメチョメ	XX∥t	0
ちょめちょめ	XX∥t	0
チョロチョロ	졸졸∥t	0
チラチラ	힐끔힐끔∥t	0
ちらちら	힐끔힐끔∥t	0
チラホラ	드문드문∥t	0
ちらほら	드문드문∥t	0
チリチリ	오글오글∥t	0
チロチロ	졸졸∥t	0
ちろちろ	졸졸∥t	0
チンタラ	우물쭈물∥t	0
ちんたら	우물쭈물∥t	0
チンプンカン	횡설수설∥t	0
ちんぷんかん	횡설수설∥t	0
チンプンカンプン	횡설수설∥t	0
ちんぷんかんぷん	횡설수설∥t	0
ツイツイ	무심코∥t	0
ついつい	무심코∥t	0
ツイツイッ	무심코∥t	0
ツカツカ	성큼성큼∥t	0
ツケツケ	성큼성큼∥t	0
ツベコベ	이러쿵저러쿵∥t	0
ツベコベッ	이러쿵저러쿵∥t	0
ツヤツヤ	반질반질∥t	0
ツンツン	츤츤∥t	0
つんつん	츤츤∥t	0
テカテカ	반질반질∥t	0
てかてか	반질반질∥t	0
テカテカッ	반질반질∥t	0
テキパキ	척척∥t	0
テクテク	터벅터벅∥t	0
テッカテッカ	반질반질∥t	0
てっかてっか	반질반질∥t	0
でへでへ	데헤데헤∥t	0
テラテラ	번들번들∥t	0
てらてら	번들번들∥t	0
デレデレ	데레데레∥t	0
でれでれ	데레데레∥t	0
ドギマギ	갈팡질팡∥t	0
どぎまぎ	갈팡질팡∥t	0
どきまぎ	갈팡질팡∥t	0
トキメキ	두근두근∥t	0
トギレトギレ	띄엄띄엄∥t	0
とぎれとぎれ	띄엄띄엄∥t	0
トクトク	쿨렁쿨렁∥t	0
とくとく	쿨렁쿨렁∥t	0
ドクドク	쿨렁쿨렁∥t	0
どくどく	쿨렁쿨렁∥t	0	//**どくどくしい
トクトクッ	쿨렁쿨렁∥t	0
ドクドクッ	쿨렁쿨렁∥t	0
ドサドサ	우르르∥t	0
どさどさ	우르르∥t	0
ドシドシ	척척∥t	0
どしどし	척척∥t	0
ドシドシッ	척척∥t	0
ドスドス	무시무시∥t	0
どすどす	무시무시∥t	0
ドタドタ	쿵쿵∥t	0
どたどた	쿵쿵∥t	0
トタトタ	타박타박∥t	0
とたとた	타박타박∥t	0
トタトタッ	타박타박∥t	0
ドタバタ	우당탕∥t	0
トテトテ	타박타박∥t	0
とてとて	타박타박∥t	0
トテトテッ	타박타박∥t	0
ドバドバ	줄줄∥t	0
どばどば	줄줄∥t	0
どびゅどびゅ	도뷰도뷰∥t	0
ドブドブ	질퍽질퍽∥t	0
どぶどぶ	질퍽질퍽∥t	0
トボトボ	터벅터벅∥t	0
ドロッドロ	질척질척∥t	0
トロトロ	녹진녹진∥t	0
とろとろ	녹진녹진∥t	0
ドロドロ	질척질척∥t	0
トロトロッ	녹진녹진∥t	0
ドロドロッ	질척질척∥t	0
ナゴナゴ	재잘재잘∥t	0
なごなご	재잘재잘∥t	0
ナデナデ	스윽스윽∥t	0
なでなで	스윽스윽∥t	0
ナヨナヨ	나긋나긋∥t	0
ニアニア	빙긋빙긋∥t	0
ニギニギ	조물조물∥t	0
にぎにぎ	조물조물∥t	0
ニタニタ	히죽히죽∥t	0
ニチャニチャ	끈적끈적∥t	0
にちゃにちゃ	끈적끈적∥t	0
ニチュニチュ	끈적끈적∥t	0
にちゅにちゅ	끈적끈적∥t	0
ニヤニヤ	히죽히죽∥t	0
にやにや	히죽히죽∥t	0
ヌクヌク	따끈따끈∥t	0
ぬくぬく	따끈따끈∥t	0
ヌチャヌチャ	질척질척∥t	0
ぬちゃぬちゃ	질척질척∥t	0
ヌチュヌチュ	질퍽질퍽∥t	0
ぬちゅぬちゅ	질퍽질퍽∥t	0
ヌチュヌチュッ	질퍽질퍽∥t	0
ヌチョヌチョ	질퍽질퍽∥t	0
ぬちょぬちょ	질퍽질퍽∥t	0
ヌチョヌチョッ	질퍽질퍽∥t	0
ヌッチュヌッチュ	질퍽질퍽∥t	0
ぬっちゅぬっちゅ	질퍽질퍽∥t	0
ヌッチュヌッチュッ	질퍽질퍽∥t	0
ヌプッヌプッ	철퍽철퍽∥t	0
ぬぷっぬぷっ	철퍽철퍽∥t	0
ヌプヌプ	철퍽철퍽∥t	0
ぬぷぬぷ	철퍽철퍽∥t	0
ヌプヌプッ	철퍽철퍽∥t	0
ヌメヌメ	미끌미끌∥t	0
ぬめぬめ	미끌미끌∥t	0
ヌラヌラ	끈적끈적∥t	0
ぬらりくらり	뺀들뺀들∥t	0
ヌルヌル	미끈미끈∥t	0
ヌレヌレ	반들반들∥t	0
ぬれぬれ	반들반들∥t	0
ネチネチ	치근치근∥t	0
ネチャッネチャッ	꿀쩍꿀쩍∥t	0
ねちゃっねちゃっ	꿀쩍꿀쩍∥t	0
ネチャネチャ	꿀쩍꿀쩍∥t	0
ねちゃねちゃ	꿀쩍꿀쩍∥t	0
ネチャネチャッ	꿀쩍꿀쩍∥t	0
ネチョネチョ	끈적끈적∥t	0
ねちょねちょ	끈적끈적∥t	0
ネトネト	끈적끈적∥t	0
ねとねと	끈적끈적∥t	0
ネトネトッ	끈적끈적∥t	0
ネバネバ	끈적끈적∥t	0
ねばねば	끈적끈적∥t	0
ネバネバッ	끈적끈적∥t	0
ノコノコ	어슬렁어슬렁∥t	0
ノシノシ	뚜벅뚜벅∥t	0
のしのし	뚜벅뚜벅∥t	0
ノソノソ	느릿느릿∥t	0
のそのそ	느릿느릿∥t	0
ノソリノソリ	느릿느릿∥t	0
のそりのそり	느릿느릿∥t	0
ノッシノッシ	뚜벅뚜벅∥t	0
のっしのっし	뚜벅뚜벅∥t	0
のらりくらり	뺀들뺀들∥t	0
ノリノリ	룰루랄라∥t	0
のりのり	룰루랄라∥t	0
ノロノロ	꾸물꾸물∥t	0
のろのろ	꾸물꾸물∥t	0
はぁはぁ	하아하아∥t	0
はあはあ	하아하아∥t	0
バインバイン	빵빵∥t	0
ばいんばいん	빵빵∥t	0
パカパカ	뚜그닥뚜그닥∥t	0
ぱかぱか	뚜그닥뚜그닥∥t	0
ハキハキ	또릿또릿∥t	0
はきはき	또릿또릿∥t	0
バキバキ	빠직빠직∥t	0
バッキバキ	빠직빠직∥t	0
ばきばき	빠직빠직∥t	0
パキパキ	우득우득∥t	0
ぱきぱき	우득우득∥t	0
パクパク	빠끔빠끔∥t	0
ハグハグ	우걱우걱∥t	0
はぐはぐ	우걱우걱∥t	0
パクパクッ	빠끔빠끔∥t	0
バサバサ	써걱써걱∥t	0
ばさばさ	써걱써걱∥t	0
ばさばさばさ	써걱써걱써걱∥t	0
パサパサ	푸석푸석∥t	0
ぱさぱさ	푸석푸석∥t	0
バサバサッ	써걱써걱∥t	0
バシッバシッ	바식바식∥t	0
ばしっばしっ	바식바식∥t	0
バシバシ	바식바식∥t	0
ばしばし	바식바식∥t	0
パシパシ	팍팍∥t	0
ぱしぱし	팍팍∥t	0
バシバシッ	바식바식∥t	0
バシャバシャ	철퍽철퍽∥t	0
ばしゃばしゃ	철퍽철퍽∥t	0
パタパタ	탁탁∥t	0
ぱたぱた	탁탁∥t	0
バタバタ	파닥파닥∥t	0
ばたばた	파닥파닥∥t	0
バタバタッ	파닥파닥∥t	0
パチパチ	짝짝∥t	0
ぱちぱち	짝짝∥t	0
バチバチ	파식파식∥t	0
ばちばち	파식파식∥t	0
バッサバッサ	써걱써걱∥t	0
ばっさばっさ	써걱써걱∥t	0
バッタバッタ	파닥파닥∥t	0
ばったばった	파닥파닥∥t	0
ハネハネ	쭈삣쭈삣∥t	0
はねはね	쭈삣쭈삣∥t	0
ハムハム	냠냠∥t	0
はむはむ	냠냠∥t	0
ハラハラ	하늘하늘∥t	0
はらはら	하늘하늘∥t	0
パラパラ	후득후득∥t	0
ぱらぱら	후득후득∥t	0
バリバリ	바득바득∥t	0	//バリバリッと音が聞こえたような錯覚に陥るほどだった、令嬢の内部は固く閉ざされて私の侵入を拒んだが、私は圧倒的な力でそれを跳ね除けた。
ばりばり	바득바득∥t	0	//バリバリッと音が聞こえたような錯覚に陥るほどだった、令嬢の内部は固く閉ざされて私の侵入を拒んだが、私は圧倒的な力でそれを跳ね除けた。
パリパリ	파삭파삭∥t	0
バリバリッ	바득바득∥t	0	//バリバリッと音が聞こえたような錯覚に陥るほどだった、令嬢の内部は固く閉ざされて私の侵入を拒んだが、私は圧倒的な力でそれを跳ね除けた。
バンバン	팡팡∥t	0
ばんばん	팡팡∥t	0
パンパン	팡팡∥t	0
ぱんぱん	팡팡∥t	0
バンバンッ	팡팡∥t	0
パンパンッ	팡팡∥t	0
ビカビカ	반짝반짝∥t	0
びかびか	반짝반짝∥t	0
ピカピカ	번쩍번쩍∥t	0
ぴかぴか	번쩍번쩍∥t	0
ピカピカッ	번쩍번쩍∥t	0
ピッカピカ	번쩍번쩍∥t	0
ビキビキ	꿈틀꿈틀∥t	0
びきびき	꿈틀꿈틀∥t	0
ピキピキ	빠직빠직∥t	0
ぴきぴき	빠직빠직∥t	0
ピクッピクッ	쫑긋쫑긋∥t	0
ヒクッヒクッ	흠칫흠칫∥t	0
ピクピク	쫑긋쫑긋∥t	0
ぴくぴく	쫑긋쫑긋∥t	0
ヒクヒク	벌렁벌렁∥t	0	//흠칫흠칫
ひくひく	벌렁벌렁∥t	0
ピクピクッ	쫑긋쫑긋∥t	0
ヒクヒクッ	벌렁벌렁∥t	0
ヒクヒクン	벌렁벌렁∥t	0
ひくひくん	벌렁벌렁∥t	0
ヒクンヒクン	벌렁벌렁∥t	0
ピコピコ	삑삑∥t	0
ぴこぴこ	삑삑∥t	0
ヒシヒシ	오싹오싹∥t	0
ひしひし	오싹오싹∥t	0
ビシビシ	철썩철썩∥t	0
びしびし	철썩철썩∥t	0
ビシャビシャ	주륵주륵∥t	0
びしゃびしゃ	주륵주륵∥t	0
ビシャビシャッ	주륵주륵∥t	0
ビショビショ	주륵주륵∥t	0
びしょびしょ	주륵주륵∥t	0
ビジョビジョ	흠뻑흠뻑∥t	0
びじょびじょ	흠뻑흠뻑∥t	0
ビショビショッ	주륵주륵∥t	0
ビタビタ	질척질척∥t	0
びたびた	질척질척∥t	0
ヒタヒタ	찰싹찰싹∥t	0
ひたひた	찰싹찰싹∥t	0
ピチピチ	팔딱팔딱∥t	0
ぴちぴち	팔딱팔딱∥t	0
ビチビチ	후드득후드득∥t	0
びちびち	후드득후드득∥t	0
ビチビチッ	후드득후드득∥t	0
ビチャビチャ	철벅철벅∥t	0
びちゃびちゃ	철벅철벅∥t	0
ビチョビチョ	질척질척∥t	0
びちょびちょ	질척질척∥t	0
ピッカピッカ	번쩍번쩍∥t	0
ぴっかぴっか	번쩍번쩍∥t	0
ピッピッ	픽픽∥t	0
ぴっぴっ	픽픽∥t	0
ヒヤヒヤ	조마조마∥t	0
ビュクビュク	뷰크뷰크∥t	0
びゅくびゅく	뷰크뷰크∥t	0
ヒョウヒョウ	휘잉휘잉∥t	0
ひょうひょう	휘잉휘잉∥t	0
ヒョコヒョコ	깡총깡총∥t	0
ひょこひょこ	깡총깡총∥t	0
ピョコピョコ	폴짝폴짝∥t	0
ぴょこぴょこ	폴짝폴짝∥t	0
ヒョロヒョロ	비실비실∥t	0
ひょろひょろ	비실비실∥t	0
ピョンピョン	피용피용∥t	0
ぴょんぴょん	피용피용∥t	0
ビラビラ	펄럭펄럭∥t	0
びらびら	펄럭펄럭∥t	0
ピラピラ	펄럭펄럭∥t	0
ピリピリ	따끔따끔∥t	0
ぴりぴり	따끔따끔∥t	0
ビリビリ	찌릿찌릿∥t	0
びりびり	찌릿찌릿∥t	0
ピリピリッ	따끔따끔∥t	0
ビンビン	펄떡펄떡∥t	0
びんびん	펄떡펄떡∥t	0
ピンピン	펄떡펄떡∥t	0
ぴんぴん	펄떡펄떡∥t	0
ビンビンッ	펄떡펄떡∥t	0
ピンピンッ	펄떡펄떡∥t	0
フガフガ	웅얼웅얼∥t	0
ふがふが	웅얼웅얼∥t	0
ブカブカ	헐렁헐렁∥t	0
フキフキ	쓱싹쓱싹∥t	0
ふきふき	쓱싹쓱싹∥t	0
フギャフギャ	후갸후갸∥t	0
ふぎゃふぎゃ	후갸후갸∥t	0
ブシュッブシュッ	부슛부슛∥t	0
ぶしゅっぶしゅっ	부슛부슛∥t	0
プチプチ	뽁뽁∥t	0
ぷちぷち	뽁뽁∥t	0
ブチブチ	투덜투덜∥t	0
ぶちぶち	투덜투덜∥t	0
ブチブチッ	투덜투덜∥t	0
ブツクサ	투덜투덜∥t	0
ぶつくさ	투덜투덜∥t	0
フツフツ	부글부글∥t	0
プツプツ	톡톡∥t	0
ぷつぷつ	톡톡∥t	0
ブツブツ	투덜투덜∥t	0
ぶつぶつ	투덜투덜∥t	0
ブツブツッ	투덜투덜∥t	0
フニフニ	말랑말랑∥t	0
ふにふに	말랑말랑∥t	0
プニプニ	말랑말랑∥t	0
ぷにぷに	말랑말랑∥t	0
フニフニッ	말랑말랑∥t	0
プニプニッ	말랑말랑∥t	0
フニャフニャ	흐물흐물∥t	0
ふにゃふにゃ	흐물흐물∥t	0
フニャフニャッ	흐물흐물∥t	0
フニュフニュ	말랑말랑∥t	0
ふにゅふにゅ	말랑말랑∥t	0
フニンフニン	말랑말랑∥t	0
ふにんふにん	말랑말랑∥t	0
プニンプニン	말랑말랑∥t	0
ぷにんぷにん	말랑말랑∥t	0
フニンフニンッ	말랑말랑∥t	0
プニンプニンッ	말랑말랑∥t	0
フムフム	흠흠∥t	0
ふむふむ	흠흠∥t	0
フヨフヨ	푹신푹신∥t	0
ふよふよ	푹신푹신∥t	0
プラプラ	어슬렁어슬렁∥t	0
ぷらぷら	어슬렁어슬렁∥t	0
ふらりふらり	흔들흔들∥t	0
ブランブラン	덜렁덜렁∥t	0
ぶらんぶらん	덜렁덜렁∥t	0
フリフリ	살랑살랑∥t	0
ふりふり	살랑살랑∥t	0
ブリブリ	탱탱∥t	0
ぶりぶり	탱탱∥t	0
プリプリ	탱탱∥t	0
ぷりぷり	탱탱∥t	0
プリプリッ	탱탱∥t	0
プリンプリン	포동포동∥t	0
ぷりんぷりん	포동포동∥t	0
ブルッブルッ	부들부들∥t	0
プルプル	부들부들∥t	0
ぷるぷる	부들부들∥t	0
フルフル	흔들흔들∥t	0
ふるふる	흔들흔들∥t	0
プルプルッ	부들부들∥t	0
フルフルッ	흔들흔들∥t	0
ブルンブルン	부릉부릉∥t	0
ぶるんぶるん	부릉부릉∥t	0
プルンプルン	포동포동∥t	0
ぷるんぷるん	포동포동∥t	0
プルンプルンッ	포동포동∥t	0
フワフワ	둥실둥실∥t	0
ブンブン	붕붕∥t	0
ぶんぶん	붕붕∥t	0	//首をブンブンと振った。
フンフン	흥흥∥t	0
ブンブンッ	붕붕∥t	0
ヘコヘコ	굽실굽실∥t	0
へこへこ	굽실굽실∥t	0
ベコベコ	꼬르륵꼬르륵∥t	0
べこべこ	꼬르륵꼬르륵∥t	0
ペコペコ	꾸벅꾸벅∥t	0
ぺこぺこ	꾸벅꾸벅∥t	0
ペシペシ	짝짝∥t	0
ぺしぺし	짝짝∥t	0
ベシベシ	파밧파밧∥t	0
べしべし	파밧파밧∥t	0
ベタベタ	끈적끈적∥t	0
べたべた	끈적끈적∥t	0
ペタペタ	철썩철썩∥t	0
ぺたぺた	철썩철썩∥t	0
ベタベタッ	끈적끈적∥t	0
ペチペチ	찰싹찰싹∥t	0
ぺちぺち	찰싹찰싹∥t	0
ペチャペチャ	재잘재잘∥t	0
ぺちゃぺちゃ	재잘재잘∥t	0
ぺちゃくちゃ	재잘재잘∥t	0
ペチャクチャ	재잘재잘∥t	0
ベチャベチャ	질철질척∥t	0
べちゃべちゃ	질철질척∥t	0
ベチョベチョ	들썩들썩∥t	0
べちょべちょ	들썩들썩∥t	0
ベッタベッタ	끈적끈적∥t	0
べったべった	끈적끈적∥t	0
ヘトヘト	기진맥진∥t	0
へとへと	기진맥진∥t	0
ベトベト	끈적끈적∥t	0
ヘナヘナ	비실비실∥t	0
へなへな	비실비실∥t	0
ヘナヘナッ	비실비실∥t	0
ヘニャヘニャ	흐물흐물∥t	0
へにゃへにゃ	흐물흐물∥t	0
ヘニャヘニャッ	흐물흐물∥t	0
ヘベレケ	헤롱헤롱∥t	0
へべれけ	헤롱헤롱∥t	0
ヘラヘラ	실실∥t	0
へらへら	실실∥t	0
ヘロヘロ	비실비실∥t	0
へろへろ	비실비실∥t	0
ヘロヘロッ	비실비실∥t	0
ベロリベロリ	할짝할짝∥t	0
ほいほい	척척∥t	0
ボインボイン	빵빵∥t	0
ぼいんぼいん	빵빵∥t	0
ボカボカ	콩콩∥t	0
ぼかぼか	콩콩∥t	0
ポキポキ	뚜둑뚜둑∥t	0
ぽきぽき	뚜둑뚜둑∥t	0
ボキボキ	뽀각뽀각∥t	0
ぼきぼき	뽀각뽀각∥t	0
ホクホク	싱글싱글∥t	0
ほくほく	싱글싱글∥t	0
ボコボコ	불퉁불퉁∥t	0
ぼこぼこ	불퉁불퉁∥t	0
ポコポコ	퍽퍽∥t	0
ぽこぽこ	퍽퍽∥t	0
ボコボコッ	퉁퉁∥t	0
ボサボサ	부스스∥t	0
ぼさぼさ	부스스∥t	0
ホジホジ	부비부비∥t	0
ほじほじ	부비부비∥t	0
ボソボソ	소곤소곤∥t	0
ボタボタ	뚝뚝∥t	0
ぼたぼた	뚝뚝∥t	0
ポタポタ	뚝뚝∥t	0
ぽたぽた	뚝뚝∥t	0
ボタボタッ	뚝뚝∥t	0
ポタポタッ	뚝뚝∥t	0
ボチボチ	슬슬∥t	0
ぼちぼち	슬슬∥t	0
ポチポチ	총총∥t	0
ぽちぽち	총총∥t	0
ボッコボッコ	퉁퉁∥t	0
ぼっこぼっこ	퉁퉁∥t	0
ポツポツ	띄엄띄엄∥t	0
ぽつぽつ	띄엄띄엄∥t	0
ポテポテ	아장아장∥t	0
ぽてぽて	아장아장∥t	0
ポフポフ	팡팡∥t	0
ぽふぽふ	팡팡∥t	0
ボヨンボヨン	푹신푹신∥t	0
ぼよんぼよん	푹신푹신∥t	0
ボリボリ	긁적긁적∥t	0
ぼりぼり	긁적긁적∥t	0
ポリポリ	긁적긁적∥t	0
ぽりぽり	긁적긁적∥t	0
ほれぼれ	황홀황홀∥t	0
ホワホワ	둥실둥실∥t	0
ほわほわ	둥실둥실∥t	0
ポワポワ	어리버리∥t	0
ぽわぽわ	어리버리∥t	0
ポワポワッ	어리버리∥t	0
マジマジ	초롱초롱∥t	0
まじまじ	물끄러미∥t	0
ミシミシ	삐걱삐걱∥t	0
みしみし	삐걱삐걱∥t	0
ミチミチ	가득가득∥t	0
みちみち	가득가득∥t	0
ミチミチッ	가득가득∥t	0
ミリミリ	우직우직∥t	0
みりみり	우직우직∥t	0
ムキムキ	불끈불끈∥t	0
むきむき	불끈불끈∥t	0
ムキュムキュ	울컥울컥∥t	0
むきゅむきゅ	울컥울컥∥t	0
ムクムク	뭉실뭉실∥t	0
むくむく	뭉실뭉실∥t	0
ムグムグ	우물우물∥t	0
むぐむぐ	우물우물∥t	0
ムシャクシャ	우걱우걱∥t	0
むしゃくしゃ	우걱우걱∥t	0
ムシャムシャ	우걱우걱∥t	0
むしゃむしゃ	우걱우걱∥t	0
ムチムチ	포동포동∥t	0
むちむち	포동포동∥t	0
ムチュムチュ	므츄므츄∥t	0
むちゅむちゅ	므츄므츄∥t	0
ムニムニ	물렁물렁∥t	0
むにむに	물렁물렁∥t	0
ムニャムニャ	음냐음냐∥t	0
むにゃむにゃ	음냐음냐∥t	0
ムニュムニュ	음냐음냐∥t	0
むにゅむにゅ	음냐음냐∥t	0
ムヤミヤ	마구마구∥t	0
むやみや	마구마구∥t	0
ムヤミヤタラ	마구마구∥t	0
むやみやたら	마구마구∥t	0
ムラムラ	불끈불끈∥t	0
メーメー	메에메에∥t	0
メキメキ	부쩍부쩍∥t	0
めきめき	부쩍부쩍∥t	0
メソメソ	훌쩍훌쩍∥t	0
メラメラ	활활∥t	0
メリメリ	우지직∥t	0
めりめり	우지직∥t	0
メロメロ	헤롱헤롱∥t	0
めろめろ	헤롱헤롱∥t	0
モガモガ	우걱우걱∥t	0
もがもが	우걱우걱∥t	0
モギュモギュ	냠냠∥t	0
もぎゅもぎゅ	냠냠∥t	0
モゴモゴ	우물우물∥t	0
もごもご	우물우물∥t	0
モコモコ	푹신푹신∥t	0
もこもこ	푹신푹신∥t	0
モサモサ	꾸물꾸물∥t	0
もさもさ	꾸물꾸물∥t	0
モジモジ	머뭇머뭇∥t	0
モシャモシャ	북실북실∥t	0
もしゃもしゃ	북실북실∥t	0
もしゃもしゃもしゃ	북실북실북실∥t	0
モジャモジャ	북실북실∥t	0
もじゃもじゃ	북실북실∥t	0
もじゃもじゃもじゃ	북실북실북실∥t	0
モタモタ	어물어물∥t	0
もたもた	어물어물∥t	0
モチモチ	쫄깃쫄깃∥t	0
もちもち	쫄깃쫄깃∥t	0
モニュモニュ	뭉클뭉클∥t	0
もにゅもにゅ	뭉클뭉클∥t	0
モフモフ	복실복실∥t	0
もふもふ	복실복실∥t	0
モミモミ	만지작만지작∥t	0
もみもみ	만지작만지작∥t	0
もーみもーみ	주-물주-물∥t	0
モヤモヤ	뭉게뭉게∥t	0
モワモワ	몽글몽글∥t	0
もわもわ	몽글몽글∥t	0
ヤイノヤイノ	바득바득∥t	0
やいのやいの	바득바득∥t	0
ヤキモキ	안절부절∥t	0
やきもき	안절부절∥t	0
ヤワヤワ	보들보들∥t	0
やわやわ	보들보들∥t	0
ユサユサ	흔들흔들∥t	0
ゆさゆさ	흔들흔들∥t	0
ユラユラ	흔들흔들∥t	0
ゆらゆら	흔들흔들∥t	0
ユルユル	느슨느슨∥t	0
ゆるゆる	느슨느슨∥t	0
ヨタヨタ	비틀비틀∥t	0
よたよた	비틀비틀∥t	0
ヨチヨチ	아장아장∥t	0
ヨロヨロ	비틀비틀∥t	0
よろよろ	비틀비틀∥t	0
れるれる	날름날름∥t	0
レロレロ	날름날름∥t	0
れろれろ	날름날름∥t	0
レロレロッ	날름날름∥t	0
ワイワイ	와글와글∥t	0
ワキワキ	두근두근∥t	0
わきわき	두근두근∥t	0
ワクワク	두근두근∥t	0
わくわく	두근두근∥t	0
ワシャワシャ	스글스글∥t	0
わしゃわしゃ	스글스글∥t	0
ワシワシ	조물조물∥t	0
わしわし	조물조물∥t	0
ワタワタ	허둥지둥∥t	0
わたわた	허둥지둥∥t	0
ワナワナ	와들와들∥t	0
わなわな	와들와들∥t	0
わらわら	바글바글∥t	0
ワラワラ	바글바글∥t	0
ワンワン	왕왕∥t	0
わんわん	왕왕∥t	0
ングング	얌얌∥t	0
んぐんぐ	얌얌∥t	0
恐る恐る	흠칫흠칫∥t	0
途切れ途切れ	띄엄띄엄∥t	0
書き書き	끄적끄적∥t	0
愚図愚図	꾸물꾸물∥t	0
愚図々々	꾸물꾸물∥t	0
絶え絶え	끊어질듯 끊어질듯∥t	0
切れ切れ	토막토막∥t	0
キレキレ	또박또박∥t	0
キレッキレ	또박또박∥t	0
喘ぎ喘ぎ	헐떡헐떡∥t	0
透け透け	보일듯 말듯∥t	0
惚れ惚れ	황홀황홀∥t	0
涸れ涸れ	바싹바싹∥t	0
しとしと	보슬보슬∥t	0
シトシト	보슬보슬∥t	0
静々	조용조용∥t	0
ブヨブヨ	포동포동∥t	0
ソソクサ	허둥지둥∥t	0
ぽつりぽつり	띄엄띄엄∥t	0
ポツリポツリ	띄엄띄엄∥t	0
じゃらじゃら	짤랑짤랑∥t	0
あわあわ	아와아와∥t	0
にゅるにゅる	미끄덩미끄덩∥t	0
ニュルニュル	미끄덩미끄덩∥t	0
ベットベト	끈적끈적∥t	0	//こんなにベットベトでニュルニュルになってるよ？
びっくんびっくん	흠칫흠칫∥t	0
しゅるしゅる	스륵스륵∥t	0
甘々	달콤달콤∥t	0
ふくふく	푹신푹신∥t	0
ちりんちりん	치링치링∥t	0
こつりこつり	탁탁∥t	0	//こつりこつりと、杖を地面に突いて、
どたんばたん	퉁탕퉁탕∥t	0
どったんばったん	퉁탕퉁탕∥t	0
ビッキビキ	꿈틀꿈틀∥t	0
苛々	안절부절∥t	0	//ちょっと苛々してて
ごとごと	덜걱덜덕∥t	0
ゴトゴト	덜걱덜덕∥t	0
どぼどぼ	느릿느릿∥t	0	//そう言ってどぼどぼとコップに焼酎を注ぐ柚子ちゃん。
イキイキ	생생∥t	0	//特に署長は前以上にイキイキしてますよ。
ドキドキ	두근두근∥t	0
ドッキドッキ	두근두근∥t	0
ドッキドキ	두근두근∥t	0
どきどき	두근두근∥t	0
どっきどっき	두근두근∥t	0
どっきどき	두근두근∥t	0
盛り盛り	와작와작∥t	0	//フルーツ盛り盛りのトロピカルドリンク
ぽんぽん	팡팡∥t	0
ぽんぽんぽん	팡팡팡∥t	0
ぷつりぷつり	툭툭∥t	0	//ぷつりぷつりと切れてゆく。
ふらふら	휘청휘청∥t	0	//今までふらふらと歩いていたんだ。
フラフラ	휘청휘청∥t	0	//今までふらふらと歩いていたんだ。
ぽそぽそ	소곤소곤∥t	0	//ぽそぽそと小さな声でしゃべってたので
ポソポソ	소곤소곤∥t	0	//ぽそぽそと小さな声でしゃべってたので
ぼやぼや	어리버리∥t	0
ボヤボヤ	어리버리∥t	0
ぽやぽや	어리버리∥t	0
ポヤポヤ	어리버리∥t	0
ブインブイン	붕붕∥t	0
しゃわしゃわ	살랑살랑∥t	0
喧々囂々	왁자지껄∥t	0
喧喧囂囂	왁자지껄∥t	0
とことこ	타박타박∥t	0
トコトコ	타박타박∥t	0
ちゃっちゃっ	착착∥t	0
チャッチャッ	착착∥t	0
よれよれ	구깃구깃∥t	0
ヨレヨレ	구깃구깃∥t	0
きゃわきゃわ	꺄와꺄와∥t	0
ごしょごしょ	중얼중얼∥t	0
わさわさ	술렁술렁∥t	0
ちょこちょこ	촐랑촐랑∥t	0
きゃらきゃら	키득키득∥t	0
キャラキャラ	키득키득∥t	0
どくりどくり	쿨렁쿨렁∥t	0
ハァハァハァ	하아하아하아∥t	0
ハァハァ	하아하아∥t	0
ハアハアハア	하아하아하아∥t	0
ハアハア	하아하아∥t	0
ギャンギャン	캉캉∥t	0
ギャンギャンギャン	캉캉캉∥t	0
けらけら	깔깔∥t	0
ぎっこんばっこん	쿵덕쿵덕∥t	0
ぎったんばっこん	쿵덕쿵덕∥t	0
ぎっこんばったん	쿵덕쿵덕∥t	0
ギッコンバッコン	쿵덕쿵덕∥t	0
ギッタンバッコン	쿵덕쿵덕∥t	0
ギッコンバッタン	쿵덕쿵덕∥t	0
わぁわぁ	와아와아∥t	0
わぁわぁわぁ	와아와아와아∥t	0
ぱっぱっ	팟팟∥t	0
ぱっぱっぱっ	팟팟팟∥t	0
くうくう	쿠우쿠우∥t	0
くうくうくう	쿠우쿠우쿠우∥t	0
びっきびき	꿈틀꿈틀∥t	0
ちゅぱちゅぱ	츄파츄파∥t	0
んしょんしょ	영차영차∥t	0
げこげこ	개굴개굴∥t	0
えっちらおっちら	영차영차∥t	0
うはうは	우하우하∥t	0
うりうり	うりうり∥t	0
うりうりうり	うりうりうり∥t	0
えいえい	에잇에잇∥t	0
ずこずこ	푹푹∥t	0
ズコズコ	푹푹∥t	0
きゅんきゅん	큥큥∥t	0
ぴくんぴくん	움찔움찔∥t	0
ぶぐぶく	부글부글∥t	0
ぷすぷす	푸슉푸슉∥t	0
みゃあみゃあ	먀아먀아∥t	0
むざむざ	호락호락∥t	0
わやわや	와글와글∥t	0
グデングデン	곤드레만드레∥t	0
//そこそこ	그럭저럭∥t	0	//五百円そこそこしか無い 처럼 "안팎" 이라는 의미가 있다.
らぶらぶ	러브러브∥t	0
とびとび	띄엄띄엄∥t	0
トビトビ	띄엄띄엄∥t	0
るりるり	루리루리∥t	0
ルリルリ	루리루리∥t	0
とつとつ	더듬더듬∥t	0
トツトツ	더듬더듬∥t	0
モニョモニョ	웅얼웅얼∥t	0
もにょもにょ	웅얼웅얼∥t	0
ベロンベロン	헤롱헤롱∥t	0
べろんべろん	헤롱헤롱∥t	0
ちゅんちゅん	츈츈∥t	0
見す見す	멀뚱멀뚱∥t	0
ちゃりちゃり	짤랑짤랑∥t	0
チャリチャリ	짤랑짤랑∥t	0
だらんだらん	주렁주렁∥t	0
ダランダラン	주렁주렁∥t	0
がっぽがっぽ	듬뿍듬뿍∥t	0
ガッポガッポ	듬뿍듬뿍∥t	0
つるっつる	반질반질∥t	0
ペラッペラ	나불나불∥t	0
ぴっこぴこ	삑삑∥t	0
ぺっこぺこ	꾸벅꾸벅∥t	0
ベショベショ	주륵주륵∥t	0
べしょべしょ	주륵주륵∥t	0
すっかすか	척척∥t	0
えろえろ	에로에로∥t	0
ぼうぼう	활활∥t	0
イッチャイッチャ	러브러브∥t	0
べったべた	끈적끈적∥t	0
びっしょびしょ	주륵주륵∥t	0
ぴっちぴち	팔딱팔딱∥t	0
ぼっこぼこ	울퉁불퉁∥t	0
かぴかぴ	거칠거칠∥t	0
カピカピ	거칠거칠∥t	0
凄い凄い	굉장해 굉장해∥t	0
バキバキッ	빠직빠직∥t	0
かっぽかっぽ	뚜닥뚜닥∥t	0
カッポカッポ	뚜닥뚜닥∥t	0
にゃむにゃむ	냠냠∥t	0
ニャムニャム	냠냠∥t	0
ごてごて	더덕더덕∥t	0
ごってごて	더덕더덕∥t	0
ゴテゴテ	더덕더덕∥t	0
ゴッテゴテ	더덕더덕∥t	0
サッサッ	삭삭∥t	0
さっさっ	삭삭∥t	0
にまにま	빙글빙글∥t	0
ニマニマ	빙글빙글∥t	0
ニャンニャン	냥냥∥t	0
ずらずら	줄줄∥t	0
ズラズラ	줄줄∥t	0
ボリボリッ	긁적긁적∥t	0
ワサワサ	술렁술렁∥t	0
ぐでぐで	곤드레만드레∥t	0
グデグデ	곤드레만드레∥t	0
サラサラッ	졸졸∥t	0
コソコソッ	소곤소곤∥t	0
ぜいぜい	헥헥∥t	0
によによ	히죽히죽∥t	0
ほっかほか	후끈후끈∥t	0
ぱちぱちぱち	짝짝짝∥t	0
ホイホイ	척척∥t	0
ボッコボコ	불퉁불퉁∥t	0
かっぽらかっぽら	뚜그닥 뚜그닥∥t	0
カッポラカッポラ	뚜그닥 뚜그닥∥t	0
ちゅぷちゅぷ	츗푸츗푸∥t	0
なあなあ	적당적당∥t	0
だばだば	타닥타닥∥t	0
ダバダバ	타닥타닥∥t	0
モッフモフ	복실복실∥t	0
もっしゃもっしゃ	북실북실∥t	0
ばちゃばちゃ	철벅철벅∥t	0
バチャバチャ	철벅철벅∥t	0
くんかくんか	킁카킁카∥t	0
ちんちんかもかも	알콩달콩∥t	0
ぷいぷい	뿌이뿌이[ぷいぷい]∥t	0
もらもら	뭉글뭉글∥t	0
モラモラ	뭉글뭉글∥t	0
たったったっ	탓탓탓∥t	0	//たったったっと小刻みなテンポの足音がジャンクの山の中から聞こえてきた。
バタンバタン	덜컹덜컹∥t	0
どぷどぷ	도푸도푸∥t	0
ちょんちょん	춍춍∥t	0
じょろじょろ	졸졸∥t	0
プイップイッ	푸잇푸잇∥t	0
さすさす	슥삭슥삭∥t	0
さすさすさす	슥삭슥삭슥삭∥t	0
のたくた	꾸물꾸물∥t	0
ゲホッゲホッ	쿨럭쿨럭∥t	0
めりゅめりゅ	우직우직∥t	0
にゅちにゅち	질척질척∥t	0
ベッタベタ	끈적끈적∥t	0
ぽむぽむ	통통∥t	0
しめしめ	해냈다 해냈다∥t	0
きゃいきゃい	꺄아꺄아∥t	0
のたのた	느릿느릿∥t	0
くらりくらり	어질어질∥t	0
ぶっかぶか	헐렁헐렁∥t	0
むやむや	울렁울렁∥t	0
ぱふぱふ	파후파후∥t	0
パフパフ	파후파후∥t	0
ぽすんぽすん	툭툭∥t	0
むっちむち	포동포동∥t	0
びたんびたん	펄떡펄떡∥t	0
ぐずくず	꾸물꾸물∥t	0
充ち満ち	가득가득∥t	0
へどもど	갈팡질팡∥t	0
萌え萌え	모에모에∥t	0
もえもえ	모에모에∥t	0
モエモエ	모에모에∥t	0
ひらりひらり	폴랑폴랑∥t	0
あやふや	흐리멍텅∥t	0
ぬっくぬく	따끈따끈∥t	0
ムッチムチ	포동포동∥t	0
よいしょよいしょ	영차영차∥t	0
ざんざん	좍좍∥t	0
どっぱどっぱ	콸콸∥t	0
ヨボヨボ	비틀비틀∥t	0
ぷりっぷり	탱탱∥t	0
ぐらんぐらん	울렁울렁∥t	0
コネコネ	조물조물∥t	0
こねこね	조물조물∥t	0	//こねこねとマッサージされ、扱かれる
ぱんっぱんっ	팡팡∥t	0
わーいわーい	와-이와-이∥t	0
げらげらげら	껄껄껄∥t	0
こつんこつん	코츤코츤∥t	0
うにょうにょ	꼼질꼼질∥t	0
ぐちゅっぐちゅっ	구츗규츗∥t	0
ぎりぎりぎり	빠듯빠듯빠듯∥t	0
わいのわいの	재잘재잘∥t	0

//▰ ~り형 ('부)
アッサリ	시원스럽게∥r	0
アッサリッ	시원스럽게∥r	0
//ウットリ	멍하게∥r	0
がくり	풀썩∥r	0
ガチャリ	짤각∥r	0
カチャリ	철컥∥r	0
かちゃり	철컥∥r	0
ガチャリッ	짤각∥r	0
カチャリッ	철컥∥r	0
かちり	짤깍∥r	0
がっくり	풀썩∥r	0
カッチリ	꼭∥r	0
ガッチリ	단단히∥r	0
カッチリッ	꼭∥r	0
ガッツリ	마음껏∥r	0	//おれはがっつり食うから、
がっつり	마음껏∥r	0	//おれはがっつり食うから、
ガッツリッ	마음껏∥r	0	//おれはがっつり食うから、
ぎっくり	삐끗∥r	0
ギックリ	움찔∥r	0
ギックリッ	움찔∥r	0
ギッシリ	가득∥r	0
ギッシリッ	가득∥r	0
キッチリ	빈틈없이∥r	0
キッチリッ	빈틈없이∥r	0
キッパリ	단호히∥r	0
キッパリッ	단호히∥r	0
ぎろり	번득∥r	0
ぐさり	푸욱∥r	0
くしゃり	꾸깃∥r	0
ぐしゃり	폭삭∥r	0
クチュリ	질척∥r	0
くちゅり	질척∥r	0
クチュリッ	질척∥r	0
クッキリ	선명하게∥r	0
クッキリッ	선명하게∥r	0
クッショリ	흠뻑∥r	0
グッショリ	흠뻑∥r	0
クッショリッ	흠뻑∥r	0
グッショリッ	흠뻑∥r	0
グッスリ	푹∥r	0
クッチュリ	질척∥r	0
クッチュリッ	질척∥r	0
グニャリ	흐늘흐늘∥r	0
ぐにゃり	흐늘흐늘∥r	0
ぐびり	꿀꺽∥r	0
くるり	빙글∥r	0
クルリと	휙∥r	0	//そしてクルリとこちらを向くと、大きな目をパッチリと開いて
ゲッソリ	홀쭉∥r	0
ゲッソリッ	홀쭉∥r	0
ごきゅり	꿀꺽∥r	0
こくり	끄덕∥r	0
ごろり	데구르르∥r	0	//西瓜をごろりと転がす
サックリ	싹둑∥r	0
さっくり	싹둑∥r	0
ザックリ	썩둑∥r	0
ざっくり	썩둑∥r	0
サックリッ	싹둑∥r	0
ザックリッ	썩둑∥r	0
シッカリ	확실히∥r	0
ジックリ	차분히∥r	0
ジックリッ	차분히∥r	0
シットリ	촉촉히∥r	0
しっとり	촉촉히∥r	0
シットリッ	촉촉히∥r	0
シャッキリ	꼿꼿하게∥r	0
しゃっきり	꼿꼿하게∥r	0	//気持がしゃっきりした
シャッキリッ	꼿꼿하게∥r	0
じゅるり	주르륵∥r	0
ションボリ	맥없이∥r	0
ションボリッ	맥없이∥r	0
じろり	흘깃∥r	0
じわり	차츰∥r	0
じんわり	서서히∥r	0
ずきり	욱신∥r	0
ずしり	묵직∥r	0
スッキリサッパリ	개운상쾌∥r	0
すっきりさっぱり	개운상쾌∥r	0
ズッシリ	묵직∥r	0
ずっしり	묵직∥r	0
ズッシリッ	묵직∥r	0
スッパリ	싹둑∥r	0
すっぱり	싹둑∥r	0
スッパリッ	싹둑∥r	0
ズッポリ	쭈욱∥r	0
ずっぽり	쭈욱∥r	0
スッポリ	푹∥r	0
ズッポリッ	쭈욱∥r	0
スッポリッ	푹∥r	0
ずぶり	푸욱∥r	0
するり	스르륵∥r	0
ずるり	주르룩∥r	0
ぞくり	흠칫∥r	0
そろり	스르르∥r	0
ぞわり	섬칫∥r	0
タップリ	충분히∥r	0
タップリッ	충분히∥r	0
ちくり	따끔∥r	0
ちらり	슬쩍∥r	0
ちろり	언뜻∥r	0
つるり	반들반들∥r	0
デップリ	뒤룩뒤룩∥r	0
でっぷり	뒤룩뒤룩∥r	0
どきり	철렁∥r	0
ドッカリ	털썩∥r	0	//不作法にドッカリとソファーに座った。
ドッカリッ	털썩∥r	0
ドッキリ	철렁∥r	0
どっきり	철렁∥r	0
トロリ	걸쭉∥r	0
とろり	걸쭉∥r	0
ドロリ	걸쭉∥r	0
どろり	걸쭉∥r	0
どんより	흐리멍텅∥r	0
にこり	생긋∥r	0
ニッコリ	생긋∥r	0
ニッコリッ	생긋∥r	0
にゅるり	미끌∥r	0
ニンマリ	빙그레∥r	0
ニンマリッ	빙그레∥r	0
ぬちゃり	질척∥r	0
ぬちゅり	질퍽∥r	0
ぬっぷり	쑤욱∥r	0
ヌルリ	미끌∥r	0
ぬるり	미끌∥r	0
ヌルリッ	미끌∥r	0
ねっとり	끈적∥r	0
のっぺり	두리뭉실∥r	0
ぱくり	뻐끔∥r	0
ぱしゃり	찰칵∥r	0
パックリ	빠끔히∥r	0
パックリッ	빠끔히∥r	0
バッサリ	싹둑∥r	0
ばっさり	싹둑∥r	0
バッサリッ	싹둑∥r	0
ばったり	털썩∥r	0
パッチリ	또렷이∥r	0	//目をパッチリと開いて
バッチリ	확실히∥r	0
ばっちり	확실히∥r	0
バッチリッ	확실히∥r	0
バチャリ	확실히∥r	0
ばちゃり	확실히∥r	0
びくり	흠칫∥r	0
ぴくり	흠칫∥r	0
ぴしゃり	철썩∥r	0
ピシャリ	철썩∥r	0
びしり	퍼벅∥r	0
ぴっしゃり	철썩∥r	0
ビッショリ	흠뻑∥r	0
ビッショリッ	흠뻑∥r	0
ピッタリ	딱∥r	0
ピッタリッ	딱∥r	0
ひょっくり	불쑥∥r	0
ひょっこり	불쑥∥r	0
ぷっくり	볼록∥r	0
プックリ	불록∥r	0
ふらり	불쑥∥r	0
ぶるり	브르르∥r	0
フンワリ	둥실∥r	0
ふんわり	둥실∥r	0
ぺこり	꾸벅∥r	0
ベッタリ	찰싹∥r	0
ベッタリッ	찰싹∥r	0
ベットリ	흠뻑∥r	0
ベットリッ	흠뻑∥r	0
ぺろり	낼름∥r	0
べろり	할짝∥r	0
ぽかり	딱∥r	0
ぼそり	중얼∥r	0
ポッカリ	뻐끔∥r	0
ぽっかり	뻐끔∥r	0
ポッカリッ	뻐끔∥r	0
ぽっくり	덜컥∥r	0
ボッコリ	볼록∥r	0
ぼっこり	볼록∥r	0
ポッコリ	볼록∥r	0
ぽっこり	볼록∥r	0
ボッコリッ	볼록∥r	0
ポッコリッ	볼록∥r	0
ほっそり	호리호리∥r	0
ぽとり	툭∥r	0
ぼろり	도르륵∥r	0
ぽろり	툭∥r	0
ほんのり	어렴풋이∥r	0
みっちり	충분히∥r	0
むくり	벌떡∥r	0
ムッチリ	포동포동∥r	0
むっちり	포동포동∥r	0
もっちり	쫄깃∥r	0
ゆらり	흔들∥r	0
れろり	할짝∥r	0
ヒッソリ	고요히∥r	0
ふにゅり	말랑∥r	0
フニュリ	말랑∥r	0
ひんやり	썰렁∥r	0
ヒンヤリ	썰렁∥r	0
ふうわり	둥실∥r	0
ぽっちゃり	포동포동∥r	0	//本人はぽっちゃり気味の体型を気にしているが、
ポッチャリ	포동포동∥r	0	//本人はぽっちゃり気味の体型を気にしているが、
コッソリ	살짝∥r	0
ジットリ	축축히∥r	0
小ぢんまり	아담하게∥r	0
ぱったり	딱∥r	0
むっくり	봉긋∥r	0
薄ぼんやり	희미하게∥r	0
ぼんやり	멍하니∥r	0
ぽんやり	멍하니∥r	0
ぽってり	통통∥r	0
びしゃり	철푸덕∥r	0
ぞぶり	후루룩∥r	0
こりり	까드득∥r	0
ぬらり	미끌∥r	0
こぽり	부글∥r	0
きょろり	힐끔∥r	0
ぎょろり	힐긋∥r	0
もっこり	불룩∥r	0
ヒョッコリ	불쑥∥r	0
チャッカリ	약삭빠르게∥r	0
とびっきり	월등히	1
ギョロリ	힐끗∥r	0
ぽきり	똑∥r	0
ばさり	바스락∥r	0
ボッキリ	뚝∥r	0
ぼっきり	뚝∥r	0
ぐってり	축∥r	0	//部屋でぐってりとしていると、扉がノックされた。 
ぽっとり	똑∥r	0
すっかりさっぱり	완전 깔끔히∥r	0
スッカリサッパリ	완전 깔끔히∥r	0
ほっこり	따듯하게∥r	0
あんぐり	쩍∥r	0	//멍청하니 입을 딱 벌린 모양 ティファニアはだらしなく口をあんぐり開けそうになった。
はんなり	우아하게∥r	0
うすぼんやり	희미하게∥r	0
のんべんだらり	빈둥빈둥∥r	0	//クラスの皆さんがのんべんだらりと準備運動を
のっしり	묵직하게∥r	0
しぃっかり	확실히∥r	0	//君の温もり、しぃっかり堪能させてもらうよ
もっさり	우둔하게∥r	0
ふにゃり	말랑∥r	0
ゆったり	낙낙하게∥r	0
ぐっちょり	질척∥r	0
じゅわり	주왁∥r	0	//お腹の奥からじゅわりと愛液が分泌されていく
パッタリ	딱∥r	0
ハッきり	분명히∥r	0

//▰ 그외 형태 ('부) (원어나 번역어가 ABxB가 아님)
よっこいしょ	영차∥t	0	//
ドンピシャ	딱∥t	0	//딱 들어맞는 모양. サイズはどんぴしゃりだ
どんぴしゃ	딱∥t	0	//딱 들어맞는 모양. サイズはどんぴしゃりだ
ドンピシャリ	딱∥t	0	//딱 들어맞는 모양. サイズはどんぴしゃりだ
どんぴしゃり	딱∥t	0	//딱 들어맞는 모양. サイズはどんぴしゃりだ
フックラ	포동포동∥t	0
ふっくら	포동포동∥t	0
ブックラ	포동포동∥t	0
ぶっくら	포동포동∥t	0
プックラ	포동포동∥t	0
ぷっくら	포동포동∥t	0
ペタンコ	납작∥t	0
ぺたんこ	납작∥t	0
ペッタンコ	납작∥t	0
ぺったんこ	납작∥t	0
ぺっちゃんこ	납작∥t	0
ぺちゃんこ	납작∥t	0
ペチャンコ	납작∥t	0
ペッチャンコ	납작∥t	0
ホンワカ	평온∥t	0	//ほんわかとした気分
ほんわか	평온∥t	0	//ほんわかとした気分
散り散り	산산히∥t	0	//一家が散り散りになる
ツラツラ	곰곰히∥t	0
しみじみ	절절히∥t	0
染染	절절히∥t	0
くんずほぐれつ	엎치락 뒤치락∥t	0
離ればなれ	따로 따로 떨어짐	1
離れ離れ	따로 따로 떨어짐	1
はなればなれ	따로 따로 떨어짐	1
ドサクサ	혼잡	1
だましだまし	조심조심	0
騙し騙し	조심조심	0
怖々	조심조심∥t	0	//부사
直々	직접∥t	0	//부사
細々	세세히∥t	0	//부사
精々	최대한∥t	0	//부사 : 人生精々苦しんで生きろクズ共！
熱々	뜨끈뜨끈∥t	0	//부사 : 沸騰するぐらい熱々ですこと。
熱々に	뜨겁게	0
熱々の	뜨거운	0
軽々	가볍게∥t	0
散々	심하게∥t	0
努々	결코∥t	0	//努々お忘れなきよう
訥訥	더듬더듬∥t	0
訥々	더듬더듬∥t	0
隆々	울퉁불퉁∥t	0
代々	대대로	0
極々	지극히	0
しげしげ	빈번히∥t	0
いやだいやだ	싫다싫다∥t	0
びっくら	깜짝	0
探り探り	더듬더듬	1	//と 형태로 잘 안 쓰이는 듯.
ゾッコン	홀딱∥t	0
ホトホト	정말이지	0
ほとほと	정말이지	0	//ほとほと運がないな

//'끝







//█████████████████████████████████████████████████████████████████████████████
// #.'기타
//█████████████████████████████████████████████████████████████████████████████
//반복
いいこいいこ	착한 아이 착한 아이	0
いいっていいって	괜찮다고 괜찮다고	0
いけないいけない	안 된다 안 된다	0
これこれ	이거이거	1
してないしてない	안 해 안 해	0
してるしてる	하고 있다 하고 있다	0
しないしない	안 해 안 해	0
そうかそうか	그런가 그런가	0
そうだったそうだった	그랬다 그랬다	0
そうだったそだった	그랬다 그랬다	0	//♞そだったそだった (예비1 차수에서 そうだったそだった로 바뀜)
そうだろうそうだろう	그렇겠지 그렇겠지	0
そうだろそうだろう	그렇겠지 그렇겠지	0	//♞そうだろそうだろ (사투리 차수에서 そうだろそうだろう로 바뀜)
そうでしょうそうでしょう	그렇겠죠 그렇겠죠	0
そうでしょそうでしょ	그렇겠죠 그렇겠죠	0
そうですかそうですか	그렇습니까 그렇습니까	0
そうですそうです	그렇습니다 그렇습니다	0
そうですよそうです	그래요 그래요	0
そうともそうとも	그럼그럼	0
そうなのそうなの	그래 그래	0
そーそー	그래그래	0	//「そーそー。さあ、はやく行こー！！」
だからだから	그러니까 그러니까	0
だってだって	하지만 하지만	0
ないない	없어 없어	0
なんだなんだ	뭐야 뭐야	0
なんだよなんだよ	뭐야 뭐야	0
待て待て	기다려 기다려	0
待て待って	기다려 기다려	0
何だなんだ	뭐야 뭐야	0	//なんだなんだ (연어차수에서 何だなんだ로 바뀜)
何だよなんだよ	뭐야 뭐야	0	//なんだよなんだよ (연어차수에서 何だよなんだよ로 바뀜)
い～のい～の	괜~찮아 괜~찮아	0
いいのい～の	괜~찮아 괜~찮아	0	//♞
やったやった	해냈다 해냈다	0	//わー、やったやった、やりましたーっ！
嫌だやだ	싫다 싫다	0	//やだやだ不潔なアンモニアの臭い。
分かるわかる	알아 알아	0	//♞
分かっているわかってる	알고 있다 알고 있다	0	//♞わかってるわかってる
分かっているわかっている	알고 있다 알고 있다	0	//♞わかってるわかってるわかってる。
へーきへーき	괜찮아 괜찮아	0	//「へーきへーき。前から風邪なんか引いたことないし」
見て見て	봐 봐	0
おいおいおい	이봐 이봐 이봐	0
鏡よ鏡よ	거울아 거울아	0
よくないよくない	좋지 않아 좋지 않아	0
かゆいかゆい	가렵다 가렵다	0
すまぬすまない	미안하다 미안하다	0	//♞すまぬすまぬ
怒るな怒るな	화내지마 화내지마	0
オッケーオッケー	오케이 오케이	0
行こ行こ	가자가자	0
参った参った	망했다 망했다	0
やばいやばい	위험해 위험해	0
やばいやばいやばい	위험해 위험해 위험해	0
忙し忙し	바빠 바빠	0
そうだそうだ	그렇다 그렇다	0
まてまてまて	기다려 기다려 기다려	0
えーとえーと	에-또 에-또	0
ここからこっから	여기부터 여기부터	0	//♞こっからこっから
よかったよかった	좋았다 좋았다	0
戻れ戻れ	돌아와 돌아와	0
行けるいける	갈 수 있어 갈 수 있어	0	//♞いけるいける
わかったわかった	알았다 알았다	0	//あ～わかったわかった、そうどなるなよ。
あそぼあそぼう	놀자 놀자	0	//♞あそぼあそぼ
//いやんいやん	싫엉싫엉	0
どうとかこうとか	이렇다든지 저렇다든지	0
やろやろ	하자하자	0
おっけおっけ	오케오케	0
入って入って	들어와 들어와	0
待って待って	기다려 기다려	0
分かってる分かってる	알고 있어 알고 있어	0
できないできない	할 수 없다 할 수 없다	0
どうぞどうぞ	부디 부디	0
ありがたやありがたや	고마우이 고마우이	0
いいかいいか	좋은가 좋은가	0
やってるやってる	하고 있다 하고 있다	0

//'임시
シャキッ	산뜻	0
しくしくしく	훌쩍 훌쩍 훌쩍	0
い・や	싫·어	0
お・風・呂	목·욕	0
う・そ	거·짓·말	1
しらんぷり	모르는 척	1
毎年そこそこ	매년 그럭저럭	1	//一年そこそこのうち 같은 경우 때문에 そこそこ를 등록하기는 어려움.
毎月そこそこ	매월 그럭저럭	1
毎週そこそこ	매주 그럭저럭	1
毎日梦名そこそこ	매일 그럭저럭	1	//毎日そこそこ
なんちゃって	なんちゃって(가짜)	1	//번역어가 마땅한게 없어서 임시로. なんちゃって姫様



